Input	Output
burette : m m f b f ; jug : r r m m ; SEPARATE destroy jug	burette : m m f b f ;
cup : c o o c ; canister : f m e f ; SEPARATE destroy cup	canister : f m e f ;
jug : p ; jar : o o d y d ; SEPARATE destroy jug	jar : o o d y d ;
beaker : c c r v r v ; burette : e ; SEPARATE destroy beaker	burette : e ;
thermos : o o ; cup : g r r ; SEPARATE destroy cup	thermos : o o ;
beaker : d g a g a d ; thermos : o f f ; SEPARATE destroy beaker	thermos : o f f ;
urn : o o a ; vessel : r ; flask : o o ; SEPARATE destroy vessel	urn : o o a ; flask : o o ;
burette : p p ; cup : c ; SEPARATE destroy cup	burette : p p ;
flask : e ; beaker : p f ; beaker : g ; SEPARATE destroy last beaker	flask : e ; beaker : p f ;
canister : e m y e ; vessel : b ; SEPARATE destroy vessel	canister : e m y e ;
decanter : b o b o ; canister : e ; SEPARATE destroy canister	decanter : b o b o ;
mug : o ; pitcher : r m r ; bottle : g a ; SEPARATE destroy bottle	mug : o ; pitcher : r m r ;
jug : b p a a ; flask : o o ; canister : h d ; SEPARATE destroy jug	flask : o o ; canister : h d ;
flagon : e f h e f ; jug : c y y ; decanter : c ; SEPARATE destroy jug	flagon : e f h e f ; decanter : c ;
thermos : c ; thermos : m ; SEPARATE destroy first thermos	thermos : m ;
bottle : g f o ; mug : o h o v v ; thermos : y y ; SEPARATE destroy bottle	mug : o h o v v ; thermos : y y ;
vessel : d m m y y ; bottle : c ; SEPARATE destroy vessel	bottle : c ;
canister : c b a c a ; pitcher : r r ; jar : r r ; SEPARATE destroy pitcher	canister : c b a c a ; jar : r r ;
canister : c c f r ; vessel : e c a ; SEPARATE destroy canister	vessel : e c a ;
jar : b b ; bottle : c ; cup : m ; urn : v v ; SEPARATE destroy cup	jar : b b ; bottle : c ; urn : v v ;
glass : c o o c ; jug : o e ; pitcher : b ; SEPARATE destroy glass	jug : o e ; pitcher : b ;
glass : a a e ; flagon : e e h d d h ; SEPARATE destroy flagon	glass : a a e ;
vessel : d p ; cup : f d m d ; SEPARATE destroy cup	vessel : d p ;
jug : f c o f ; mug : o o ; flask : v a m v ; SEPARATE destroy flask	jug : f c o f ; mug : o o ;
bottle : b ; beaker : c e c a a ; cup : v v ; SEPARATE destroy bottle	beaker : c e c a a ; cup : v v ;
cup : r ; thermos : c ; flask : g e f ; SEPARATE destroy cup	thermos : c ; flask : g e f ;
glass : m ; decanter : r r ; flask : o o y ; SEPARATE destroy glass	decanter : r r ; flask : o o y ;
cup : f e r e ; canister : h c ; SEPARATE destroy cup	canister : h c ;
burette : m m c ; glass : c h ; decanter : f d d ; SEPARATE destroy decanter	burette : m m c ; glass : c h ;
decanter : y y ; flagon : v ; SEPARATE destroy decanter	flagon : v ;
decanter : g b ; glass : y y ; glass : h f f a ; SEPARATE destroy decanter	glass : y y ; glass : h f f a ;
bottle : d ; urn : v v m ; urn : h h c c ; SEPARATE destroy bottle	urn : v v m ; urn : h h c c ;
mug : b r ; beaker : b b ; urn : m v m v ; jug : e ; SEPARATE destroy mug	beaker : b b ; urn : m v m v ; jug : e ;
flask : f f ; pitcher : h y o ; SEPARATE destroy pitcher	flask : f f ;
pitcher : g o o b ; cup : d m m ; SEPARATE destroy cup	pitcher : g o o b ;
urn : b y r ; jug : v ; SEPARATE destroy jug	urn : b y r ;
glass : v v d ; jug : y ; canister : f ; SEPARATE destroy jug	glass : v v d ; canister : f ;
bottle : v y v y c c ; urn : o m y ; SEPARATE destroy bottle	urn : o m y ;
canister : d ; vessel : g v g ; canister : d d f r r f ; SEPARATE destroy vessel	canister : d ; canister : d d f r r f ;
glass : f f ; thermos : g c g m ; flask : b b a a ; SEPARATE destroy glass	thermos : g c g m ; flask : b b a a ;
flask : e g ; thermos : a f o a ; SEPARATE destroy thermos	flask : e g ;
pitcher : d ; vessel : o m m h o ; decanter : g p b g p ; SEPARATE destroy pitcher	vessel : o m m h o ; decanter : g p b g p ;
pitcher : p b b p ; decanter : a a ; SEPARATE destroy pitcher	decanter : a a ;
jug : h p h ; vessel : a ; SEPARATE destroy jug	vessel : a ;
beaker : f b f e e ; bottle : g f g ; SEPARATE destroy bottle	beaker : f b f e e ;
pitcher : b h e b e ; canister : r o o ; SEPARATE destroy canister	pitcher : b h e b e ;
canister : a m p p a ; jug : c y c ; SEPARATE destroy jug	canister : a m p p a ;
beaker : d ; urn : e ; SEPARATE destroy urn	beaker : d ;
flagon : m c ; beaker : m y m ; jar : y ; pitcher : d ; SEPARATE destroy flagon	beaker : m y m ; jar : y ; pitcher : d ;
burette : p p ; jug : d v d p ; SEPARATE destroy burette	jug : d v d p ;
jug : c g g d ; thermos : o p y p ; SEPARATE destroy thermos	jug : c g g d ;
cup : p e p d d e ; flagon : b d ; SEPARATE destroy cup	flagon : b d ;
jug : o y y ; canister : y y ; burette : g ; beaker : m v ; SEPARATE destroy burette	jug : o y y ; canister : y y ; beaker : m v ;
mug : o o y v v ; flagon : d p d m ; SEPARATE destroy mug	flagon : d p d m ;
thermos : v ; decanter : d d ; mug : o o ; SEPARATE destroy decanter	thermos : v ; mug : o o ;
glass : h g ; burette : v v y y ; SEPARATE destroy glass	burette : v v y y ;
vessel : o o ; flask : a p p ; canister : d ; SEPARATE destroy vessel	flask : a p p ; canister : d ;
glass : y m y m ; pitcher : m r p ; SEPARATE destroy glass	pitcher : m r p ;
decanter : y f o ; pitcher : c e p p ; bottle : o o ; SEPARATE destroy bottle	decanter : y f o ; pitcher : c e p p ;
decanter : g y v v g ; flask : h ; flask : e g e o o ; SEPARATE destroy first flask	decanter : g y v v g ; flask : e g e o o ;
flask : o ; burette : m r y y r m ; SEPARATE destroy burette	flask : o ;
jug : c b c b ; vessel : b ; bottle : e ; SEPARATE destroy bottle	jug : c b c b ; vessel : b ;
cup : o o y ; flagon : y a r y ; SEPARATE destroy flagon	cup : o o y ;
flask : h v v y ; mug : e e ; jar : m m ; SEPARATE destroy flask	mug : e e ; jar : m m ;
jar : g b g r r ; jug : d ; decanter : g c g ; SEPARATE destroy jug	jar : g b g r r ; decanter : g c g ;
canister : p o ; canister : c f c ; flask : h d r d r ; SEPARATE destroy flask	canister : p o ; canister : c f c ;
glass : a ; urn : c a a r ; SEPARATE destroy urn	glass : a ;
urn : a ; urn : v c v ; SEPARATE destroy first urn	urn : v c v ;
jug : m d p d ; glass : y d d y ; canister : p a ; SEPARATE destroy glass	jug : m d p d ; canister : p a ;
flask : e r ; vessel : b c h c ; vessel : p p v h ; SEPARATE destroy last vessel	flask : e r ; vessel : b c h c ;
jug : y ; burette : p e a a ; SEPARATE destroy burette	jug : y ;
glass : o p ; decanter : c c y y ; SEPARATE destroy decanter	glass : o p ;
glass : d h ; beaker : o ; pitcher : r m m ; SEPARATE destroy glass	beaker : o ; pitcher : r m m ;
cup : r r ; burette : y y d ; decanter : r r y ; SEPARATE destroy decanter	cup : r r ; burette : y y d ;
flagon : y y a ; mug : a a c c g ; SEPARATE destroy flagon	mug : a a c c g ;
flagon : d ; jug : m r ; SEPARATE destroy flagon	jug : m r ;
bottle : m h m ; bottle : m p ; jug : d r h r ; SEPARATE destroy jug	bottle : m h m ; bottle : m p ;
flask : o o ; beaker : p p ; SEPARATE destroy beaker	flask : o o ;
urn : g c ; urn : g h g v ; jar : v v ; SEPARATE destroy last urn	urn : g c ; jar : v v ;
flagon : c g g c ; decanter : c p ; SEPARATE destroy flagon	decanter : c p ;
bottle : g c c h ; pitcher : b m a m ; canister : e e ; SEPARATE destroy bottle	pitcher : b m a m ; canister : e e ;
thermos : p h p ; glass : d d g g ; SEPARATE destroy glass	thermos : p h p ;
flask : b b c p c ; jug : d d ; beaker : o d b d o ; SEPARATE destroy beaker	flask : b b c p c ; jug : d d ;
decanter : v v ; canister : f h h f ; bottle : c c ; SEPARATE destroy decanter	canister : f h h f ; bottle : c c ;
vessel : v h v a h ; flagon : g d ; mug : o g ; SEPARATE destroy mug	vessel : v h v a h ; flagon : g d ;
urn : b ; flask : h b r r ; decanter : o ; pitcher : e ; SEPARATE destroy urn	flask : h b r r ; decanter : o ; pitcher : e ;
bottle : m h h y y m ; vessel : a r a ; SEPARATE destroy vessel	bottle : m h h y y m ;
jar : g p ; flagon : a b b ; jug : a a ; SEPARATE destroy jar	flagon : a b b ; jug : a a ;
glass : m m b g ; jar : y ; SEPARATE destroy glass	jar : y ;
flask : v ; mug : v v ; thermos : c c b ; thermos : o m ; SEPARATE destroy mug	flask : v ; thermos : c c b ; thermos : o m ;
decanter : d p p m ; cup : p ; bottle : y h h f ; SEPARATE destroy decanter	cup : p ; bottle : y h h f ;
glass : p v v ; vessel : b o b ; beaker : a g ; SEPARATE destroy vessel	glass : p v v ; beaker : a g ;
flagon : b v m ; bottle : g m o o ; SEPARATE destroy flagon	bottle : g m o o ;
burette : h ; burette : h ; SEPARATE destroy last burette	burette : h ;
flask : b c ; jar : b r ; SEPARATE destroy jar	flask : b c ;
jar : r m m ; thermos : m g d ; SEPARATE destroy thermos	jar : r m m ;
beaker : b e b g e ; jar : a ; canister : g ; SEPARATE destroy beaker	jar : a ; canister : g ;
beaker : f f m h m h ; cup : f d d ; SEPARATE destroy beaker	cup : f d d ;
pitcher : p ; urn : d h d h ; burette : f ; mug : o f o ; SEPARATE destroy urn	pitcher : p ; burette : f ; mug : o f o ;
jug : h h ; glass : g g d ; SEPARATE destroy glass	jug : h h ;
mug : v f f d ; flask : d d ; flask : e r r ; SEPARATE destroy mug	flask : d d ; flask : e r r ;
canister : r r g ; flask : y y ; SEPARATE destroy flask	canister : r r g ;
mug : d d f f ; canister : r r ; decanter : c o d c d ; SEPARATE destroy canister	mug : d d f f ; decanter : c o d c d ;
burette : b b d ; urn : g g ; SEPARATE destroy urn	burette : b b d ;
vessel : a ; cup : y y ; urn : h h e ; glass : d d e ; SEPARATE destroy cup	vessel : a ; urn : h h e ; glass : d d e ;
beaker : r r ; mug : g ; SEPARATE destroy mug	beaker : r r ;
mug : g g p ; flagon : p y p c c ; SEPARATE destroy mug	flagon : p y p c c ;
canister : c p ; vessel : f a f g ; bottle : e g e ; SEPARATE destroy canister	vessel : f a f g ; bottle : e g e ;
glass : g g ; jug : r r p v ; SEPARATE destroy jug	glass : g g ;
canister : e e ; cup : e a ; SEPARATE destroy canister	cup : e a ;
vessel : h h v r r ; pitcher : e e o o c c ; SEPARATE destroy pitcher	vessel : h h v r r ;
thermos : e o e a ; urn : m a a ; glass : e f ; SEPARATE destroy glass	thermos : e o e a ; urn : m a a ;
burette : c c m a a ; mug : g g ; SEPARATE destroy burette	mug : g g ;
urn : d ; mug : e h e f f ; jug : a a ; SEPARATE destroy jug	urn : d ; mug : e h e f f ;
burette : y v v b ; burette : c o o ; SEPARATE destroy last burette	burette : y v v b ;
bottle : o o d f d ; pitcher : f v ; decanter : g g ; SEPARATE destroy decanter	bottle : o o d f d ; pitcher : f v ;
flask : v y g v ; glass : o v ; jar : e o d d o ; SEPARATE destroy glass	flask : v y g v ; jar : e o d d o ;
jar : y o r y r ; cup : o o y g ; SEPARATE destroy jar	cup : o o y g ;
thermos : d c ; mug : h ; thermos : g a ; SEPARATE destroy second thermos	thermos : d c ; mug : h ;
canister : v ; canister : b b c c ; SEPARATE destroy last canister	canister : v ;
mug : v o o g g v ; flask : e ; decanter : d p p d ; SEPARATE destroy decanter	mug : v o o g g v ; flask : e ;
thermos : m ; burette : r y y r ; canister : f ; jug : r r ; SEPARATE destroy jug	thermos : m ; burette : r y y r ; canister : f ;
urn : c c y ; flask : d d ; mug : f f h h ; SEPARATE destroy mug	urn : c c y ; flask : d d ;
decanter : e a g a g ; vessel : v p c c v ; SEPARATE destroy decanter	vessel : v p c c v ;
flagon : m m ; flagon : f d f a a ; SEPARATE destroy first flagon	flagon : f d f a a ;
thermos : e ; jug : g o g a a ; SEPARATE destroy thermos	jug : g o g a a ;
mug : v g a g v ; jug : h ; urn : o d a ; SEPARATE destroy jug	mug : v g a g v ; urn : o d a ;
decanter : c c b o ; glass : o o ; SEPARATE destroy glass	decanter : c c b o ;
vessel : e e ; cup : g m ; burette : b ; SEPARATE destroy vessel	cup : g m ; burette : b ;
flagon : d ; beaker : v ; jar : h ; burette : h e h o ; SEPARATE destroy jar	flagon : d ; beaker : v ; burette : h e h o ;
vessel : y o y e ; bottle : b e e ; SEPARATE destroy vessel	bottle : b e e ;
flask : m m ; bottle : m g m a ; SEPARATE destroy flask	bottle : m g m a ;
thermos : d d ; glass : y v f v ; SEPARATE destroy glass	thermos : d d ;
beaker : c ; thermos : b b ; SEPARATE destroy beaker	thermos : b b ;
jug : v o v ; burette : g g ; glass : y g g a a y ; SEPARATE destroy glass	jug : v o v ; burette : g g ;
pitcher : g f ; flagon : f ; jar : r b c r ; SEPARATE destroy jar	pitcher : g f ; flagon : f ;
beaker : o v c o ; jar : m o m o ; jar : h v v ; SEPARATE destroy first jar	beaker : o v c o ; jar : h v v ;
canister : e e ; flagon : m ; SEPARATE destroy canister	flagon : m ;
canister : m p ; jug : f ; canister : p p ; SEPARATE destroy first canister	jug : f ; canister : p p ;
decanter : c g e g c ; jar : g ; SEPARATE destroy decanter	jar : g ;
burette : f ; jug : v o o ; jug : b y ; SEPARATE destroy last jug	burette : f ; jug : v o o ;
glass : f ; decanter : v v ; SEPARATE destroy glass	decanter : v v ;
decanter : f f m m ; pitcher : y v o o y ; SEPARATE destroy decanter	pitcher : y v o o y ;
vessel : b ; canister : y o o p ; cup : m ; urn : b ; SEPARATE destroy cup	vessel : b ; canister : y o o p ; urn : b ;
vessel : h b f ; canister : o o ; jug : b b ; SEPARATE destroy vessel	canister : o o ; jug : b b ;
jug : r r h h ; beaker : m m d p ; flagon : v y ; SEPARATE destroy jug	beaker : m m d p ; flagon : v y ;
urn : a a ; decanter : b v p p v ; canister : f h y y ; SEPARATE destroy urn	decanter : b v p p v ; canister : f h y y ;
bottle : m r h m r ; flask : a p h h p ; SEPARATE destroy flask	bottle : m r h m r ;
flagon : r f f o ; vessel : c c ; canister : a c f f c ; SEPARATE destroy flagon	vessel : c c ; canister : a c f f c ;
jug : h c h c f ; jar : h v y h v ; SEPARATE destroy jug	jar : h v y h v ;
glass : g y y ; thermos : b ; SEPARATE destroy thermos	glass : g y y ;
thermos : v y ; bottle : o ; SEPARATE destroy bottle	thermos : v y ;
decanter : c ; decanter : p ; SEPARATE destroy last decanter	decanter : c ;
burette : o ; decanter : o v o h v ; jar : r d r ; SEPARATE destroy burette	decanter : o v o h v ; jar : r d r ;
thermos : b o m ; jar : y r ; SEPARATE destroy thermos	jar : y r ;
jar : c b d b ; thermos : p h ; flagon : r ; SEPARATE destroy flagon	jar : c b d b ; thermos : p h ;
canister : a ; canister : e y ; glass : a v v ; flask : r ; SEPARATE destroy second canister	canister : a ; glass : a v v ; flask : r ;
jug : a y ; pitcher : y o r o r ; jug : f p b b ; SEPARATE destroy first jug	pitcher : y o r o r ; jug : f p b b ;
thermos : a a r ; bottle : o a h a h ; SEPARATE destroy bottle	thermos : a a r ;
bottle : m ; jar : m m ; canister : y b f b y f ; SEPARATE destroy canister	bottle : m ; jar : m m ;
pitcher : c e f c e f ; mug : c e m e ; SEPARATE destroy pitcher	mug : c e m e ;
jar : o r r ; glass : r ; SEPARATE destroy glass	jar : o r r ;
glass : g g ; pitcher : g v c c ; glass : v v p ; SEPARATE destroy last glass	glass : g g ; pitcher : g v c c ;
bottle : h v h y ; flagon : g ; SEPARATE destroy bottle	flagon : g ;
thermos : d d p ; bottle : c a c a o o ; burette : m m h ; SEPARATE destroy bottle	thermos : d d p ; burette : m m h ;
beaker : g ; flagon : f f c ; SEPARATE destroy flagon	beaker : g ;
beaker : y y ; beaker : f ; SEPARATE destroy last beaker	beaker : y y ;
pitcher : p p ; urn : o e p ; urn : r ; SEPARATE destroy last urn	pitcher : p p ; urn : o e p ;
cup : h v p v ; glass : y y ; SEPARATE destroy cup	glass : y y ;
flagon : b ; thermos : y ; SEPARATE destroy thermos	flagon : b ;
bottle : c m c f ; glass : y y ; SEPARATE destroy glass	bottle : c m c f ;
jar : p e c e ; beaker : e r e p r ; SEPARATE destroy beaker	jar : p e c e ;
jar : d e d a ; canister : e e ; cup : d m d h m ; SEPARATE destroy jar	canister : e e ; cup : d m d h m ;
mug : y ; cup : m g o m ; glass : d ; burette : g ; SEPARATE destroy glass	mug : y ; cup : m g o m ; burette : g ;
canister : r o r ; jar : e e ; flagon : a a y ; SEPARATE destroy jar	canister : r o r ; flagon : a a y ;
urn : b b h ; decanter : h h ; SEPARATE destroy decanter	urn : b b h ;
flask : h h ; flagon : f p f ; SEPARATE destroy flagon	flask : h h ;
flagon : y ; jar : y y d d ; urn : p e ; SEPARATE destroy urn	flagon : y ; jar : y y d d ;
flask : p g d d g ; cup : p r p ; SEPARATE destroy cup	flask : p g d d g ;
flask : v a b ; jug : p ; SEPARATE destroy jug	flask : v a b ;
jar : f f ; decanter : c c ; jug : b b ; bottle : p ; SEPARATE destroy bottle	jar : f f ; decanter : c c ; jug : b b ;
glass : d a ; decanter : g m v ; pitcher : c y c f ; SEPARATE destroy decanter	glass : d a ; pitcher : c y c f ;
bottle : f d d ; glass : b m r b ; glass : g g d ; SEPARATE destroy bottle	glass : b m r b ; glass : g g d ;
flask : p ; mug : r r ; SEPARATE destroy mug	flask : p ;
mug : m m ; flagon : f f ; jug : f f p b p ; SEPARATE destroy flagon	mug : m m ; jug : f f p b p ;
burette : c c ; beaker : d a ; SEPARATE destroy beaker	burette : c c ;
urn : b ; canister : f b f r ; SEPARATE destroy urn	canister : f b f r ;
jar : e e ; beaker : f v v f d ; urn : p p h ; SEPARATE destroy urn	jar : e e ; beaker : f v v f d ;
bottle : d d o y y ; mug : r r m c c m ; glass : d d ; SEPARATE destroy mug	bottle : d d o y y ; glass : d d ;
jar : y p r r ; burette : v h m ; flask : o a y ; SEPARATE destroy jar	burette : v h m ; flask : o a y ;
mug : g a a ; cup : d m d p ; SEPARATE destroy cup	mug : g a a ;
jar : a a m ; vessel : y d d y ; SEPARATE destroy jar	vessel : y d d y ;
jar : m v h h m ; thermos : y ; SEPARATE destroy thermos	jar : m v h h m ;
flagon : m v v m a ; mug : e f m e ; SEPARATE destroy mug	flagon : m v v m a ;
mug : m m a ; flagon : a a ; canister : m ; urn : g g ; SEPARATE destroy flagon	mug : m m a ; canister : m ; urn : g g ;
vessel : a m a m ; mug : b ; jar : b ; SEPARATE destroy jar	vessel : a m a m ; mug : b ;
glass : v d f f ; flagon : y o b ; jug : d ; SEPARATE destroy flagon	glass : v d f f ; jug : d ;
flask : o v ; jug : v y h y h ; SEPARATE destroy flask	jug : v y h y h ;
beaker : d h b ; urn : b b r ; SEPARATE destroy urn	beaker : d h b ;
mug : h h p m ; jug : c c ; jar : y y p ; SEPARATE destroy mug	jug : c c ; jar : y y p ;
pitcher : b m b m ; bottle : v g o g o ; SEPARATE destroy bottle	pitcher : b m b m ;
flask : b ; flagon : d p p d ; bottle : e p o o e ; SEPARATE destroy flask	flagon : d p p d ; bottle : e p o o e ;
flask : p p h f h ; thermos : r ; SEPARATE destroy flask	thermos : r ;
jug : h y y ; jar : f p p ; jug : a a p ; SEPARATE destroy first jug	jar : f p p ; jug : a a p ;
flask : f f ; flask : b g o b o ; decanter : o o d g d ; SEPARATE destroy decanter	flask : f f ; flask : b g o b o ;
flask : v r r v ; pitcher : b h b ; vessel : d a g g ; SEPARATE destroy pitcher	flask : v r r v ; vessel : d a g g ;
vessel : r r e e ; bottle : o o a g ; SEPARATE destroy vessel	bottle : o o a g ;
vessel : y p p g y ; decanter : r f h r ; canister : b b ; SEPARATE destroy decanter	vessel : y p p g y ; canister : b b ;
flagon : g ; pitcher : h e o h ; canister : c ; flagon : b ; SEPARATE destroy second flagon	flagon : g ; pitcher : h e o h ; canister : c ;
vessel : d y d ; mug : g g c c ; SEPARATE destroy vessel	mug : g g c c ;
glass : e ; jar : h h ; SEPARATE destroy jar	glass : e ;
mug : y y ; burette : e c e c ; urn : m f f m ; SEPARATE destroy burette	mug : y y ; urn : m f f m ;
vessel : y f y f o ; canister : y m y a m ; cup : h ; SEPARATE destroy vessel	canister : y m y a m ; cup : h ;
pitcher : d f ; beaker : g ; beaker : e e ; SEPARATE destroy second beaker	pitcher : d f ; beaker : g ;
mug : d d ; pitcher : g o m ; SEPARATE destroy pitcher	mug : d d ;
burette : m ; glass : v h v y ; pitcher : h y v h v ; SEPARATE destroy pitcher	burette : m ; glass : v h v y ;
decanter : r r ; glass : v p b p ; mug : d c d c ; SEPARATE destroy glass	decanter : r r ; mug : d c d c ;
burette : f ; cup : b f b ; flagon : g g ; SEPARATE destroy flagon	burette : f ; cup : b f b ;
jug : f g f ; burette : e e ; SEPARATE destroy burette	jug : f g f ;
pitcher : g ; pitcher : e ; SEPARATE destroy last pitcher	pitcher : g ;
jar : d d ; jug : a a o o ; decanter : c c d a a ; SEPARATE destroy jar	jug : a a o o ; decanter : c c d a a ;
thermos : d d a a f ; decanter : a c ; SEPARATE destroy decanter	thermos : d d a a f ;
jar : c r r ; urn : r r v ; flagon : r ; SEPARATE destroy flagon	jar : c r r ; urn : r r v ;
mug : g h g h ; beaker : h ; SEPARATE destroy beaker	mug : g h g h ;
glass : e e ; beaker : y p ; canister : a a v ; SEPARATE destroy glass	beaker : y p ; canister : a a v ;
jar : o h c ; jug : v v ; SEPARATE destroy jar	jug : v v ;
vessel : r ; burette : v a y v y ; cup : v v r r o o ; SEPARATE destroy vessel	burette : v a y v y ; cup : v v r r o o ;
jug : d c d o ; beaker : r r ; SEPARATE destroy beaker	jug : d c d o ;
flagon : r m m b ; canister : r y y ; SEPARATE destroy canister	flagon : r m m b ;
beaker : y m y ; cup : d y ; SEPARATE destroy beaker	cup : d y ;
urn : d d v v ; flagon : g ; SEPARATE destroy flagon	urn : d d v v ;
jar : y h y ; glass : o b ; SEPARATE destroy glass	jar : y h y ;
flask : c c d ; bottle : o o ; mug : r ; SEPARATE destroy bottle	flask : c c d ; mug : r ;
flask : h g g ; flask : b f b d ; urn : y p o o ; SEPARATE destroy urn	flask : h g g ; flask : b f b d ;
jar : v m ; vessel : y y r ; SEPARATE destroy jar	vessel : y y r ;
jar : y y ; jar : o o e e ; burette : b ; SEPARATE destroy burette	jar : y y ; jar : o o e e ;
thermos : d d r ; burette : y a y a ; urn : e f a e a ; SEPARATE destroy burette	thermos : d d r ; urn : e f a e a ;
pitcher : f r ; canister : o y ; pitcher : o ; SEPARATE destroy last pitcher	pitcher : f r ; canister : o y ;
urn : e b f b ; mug : c p r p ; urn : p ; SEPARATE destroy first urn	mug : c p r p ; urn : p ;
jar : e g a e a g ; jug : o o v v ; beaker : h ; SEPARATE destroy beaker	jar : e g a e a g ; jug : o o v v ;
canister : p p g ; canister : h r h ; SEPARATE destroy last canister	canister : p p g ;
cup : a a b r r ; vessel : d g ; flagon : g f d d ; SEPARATE destroy cup	vessel : d g ; flagon : g f d d ;
vessel : r r y ; mug : o o ; SEPARATE destroy vessel	mug : o o ;
bottle : v e v g g ; burette : r a r a ; SEPARATE destroy bottle	burette : r a r a ;
canister : r c ; vessel : v e e y ; SEPARATE destroy vessel	canister : r c ;
bottle : y y ; jug : m r y y r ; vessel : m ; SEPARATE destroy jug	bottle : y y ; vessel : m ;
thermos : c h y y c ; vessel : o o ; SEPARATE destroy vessel	thermos : c h y y c ;
flagon : d r d r ; decanter : b p b p ; SEPARATE destroy flagon	decanter : b p b p ;
beaker : y ; glass : m e r ; jar : v v ; SEPARATE destroy glass	beaker : y ; jar : v v ;
bottle : f p f ; decanter : r ; SEPARATE destroy bottle	decanter : r ;
glass : b f d f d ; pitcher : b b c ; SEPARATE destroy pitcher	glass : b f d f d ;
bottle : o y o y h ; mug : p p ; flask : p a f f ; SEPARATE destroy flask	bottle : o y o y h ; mug : p p ;
bottle : e h e ; decanter : r r ; urn : d d ; SEPARATE destroy urn	bottle : e h e ; decanter : r r ;
jug : f b ; pitcher : v ; vessel : d o d h h ; SEPARATE destroy pitcher	jug : f b ; vessel : d o d h h ;
decanter : g g h ; bottle : v r r ; burette : b b ; SEPARATE destroy burette	decanter : g g h ; bottle : v r r ;
urn : e e ; urn : c y f f c ; flagon : g y ; SEPARATE destroy first urn	urn : c y f f c ; flagon : g y ;
cup : h v ; jar : f m f m ; bottle : g ; cup : b ; SEPARATE destroy bottle	cup : h v ; jar : f m f m ; cup : b ;
vessel : y y ; decanter : o o ; canister : m m ; SEPARATE destroy decanter	vessel : y y ; canister : m m ;
cup : p o o ; flask : r r ; SEPARATE destroy flask	cup : p o o ;
glass : f b f g ; thermos : g b g ; jug : p ; SEPARATE destroy glass	thermos : g b g ; jug : p ;
vessel : d g g ; beaker : f ; SEPARATE destroy beaker	vessel : d g g ;
cup : r ; urn : g ; beaker : m d r ; flagon : g b g ; SEPARATE destroy flagon	cup : r ; urn : g ; beaker : m d r ;
beaker : y e r y ; thermos : y d m m y ; burette : g e g e ; SEPARATE destroy beaker	thermos : y d m m y ; burette : g e g e ;
pitcher : m ; burette : v g b ; SEPARATE destroy pitcher	burette : v g b ;
cup : m a m ; thermos : g g ; thermos : f r v f v ; SEPARATE destroy cup	thermos : g g ; thermos : f r v f v ;
bottle : r c f ; mug : g g ; SEPARATE destroy mug	bottle : r c f ;
thermos : y y ; thermos : m h p p ; SEPARATE destroy last thermos	thermos : y y ;
vessel : o o v ; urn : b ; vessel : o ; flask : h ; SEPARATE destroy first vessel	urn : b ; vessel : o ; flask : h ;
bottle : b ; burette : c v v ; glass : a e e ; SEPARATE destroy glass	bottle : b ; burette : c v v ;
decanter : c m r ; beaker : y y ; burette : c c b h ; SEPARATE destroy decanter	beaker : y y ; burette : c c b h ;
burette : p h g g p ; flask : y e y e ; SEPARATE destroy flask	burette : p h g g p ;
thermos : h ; flagon : b v b v c c ; glass : p ; SEPARATE destroy glass	thermos : h ; flagon : b v b v c c ;
burette : p p b b ; beaker : a g a g ; SEPARATE destroy burette	beaker : a g a g ;
urn : d ; jug : o g ; SEPARATE destroy urn	jug : o g ;
flagon : e b b e ; urn : f ; canister : m ; SEPARATE destroy urn	flagon : e b b e ; canister : m ;
canister : r r h ; jar : o c c ; vessel : f ; SEPARATE destroy canister	jar : o c c ; vessel : f ;
burette : a ; canister : p a p a ; SEPARATE destroy burette	canister : p a p a ;
thermos : y e ; urn : m m f f ; SEPARATE destroy urn	thermos : y e ;
canister : v ; canister : c ; SEPARATE destroy first canister	canister : c ;
flagon : c c ; jug : c c a ; jar : f v v ; SEPARATE destroy jar	flagon : c c ; jug : c c a ;
jar : g o m ; canister : o ; flagon : p v p v ; SEPARATE destroy jar	canister : o ; flagon : p v p v ;
bottle : o f ; thermos : d r d ; SEPARATE destroy thermos	bottle : o f ;
bottle : m a b a b m ; urn : a a ; SEPARATE destroy urn	bottle : m a b a b m ;
jar : o o ; bottle : g ; SEPARATE destroy jar	bottle : g ;
jug : y d y d ; bottle : m ; thermos : h c ; SEPARATE destroy jug	bottle : m ; thermos : h c ;
beaker : v y e y ; beaker : p p b a b ; SEPARATE destroy second beaker	beaker : v y e y ;
flask : b b y y p ; jar : h r r h d ; vessel : f ; SEPARATE destroy flask	jar : h r r h d ; vessel : f ;
canister : v f v f c ; cup : v y y ; burette : e ; SEPARATE destroy canister	cup : v y y ; burette : e ;
glass : g r r ; canister : p h ; SEPARATE destroy glass	canister : p h ;
thermos : m v v f ; vessel : e e ; SEPARATE destroy vessel	thermos : m v v f ;
pitcher : p ; canister : c c ; vessel : d f v f ; SEPARATE destroy vessel	pitcher : p ; canister : c c ;
thermos : b o o ; thermos : y y ; canister : r ; SEPARATE destroy canister	thermos : b o o ; thermos : y y ;
jar : o o m m b ; canister : v ; SEPARATE destroy canister	jar : o o m m b ;
pitcher : r r ; flagon : m p m ; SEPARATE destroy pitcher	flagon : m p m ;
urn : h h c c ; pitcher : p o ; SEPARATE destroy pitcher	urn : h h c c ;
cup : m f m f ; vessel : m m a ; burette : h h m m g ; SEPARATE destroy vessel	cup : m f m f ; burette : h h m m g ;
cup : b b ; urn : f g ; SEPARATE destroy cup	urn : f g ;
flagon : p ; urn : o a ; SEPARATE destroy urn	flagon : p ;
cup : a ; jar : b p a p b a ; SEPARATE destroy cup	jar : b p a p b a ;
jug : b b y ; canister : c d d y ; vessel : g ; SEPARATE destroy vessel	jug : b b y ; canister : c d d y ;
bottle : o r r o ; decanter : f v v f ; SEPARATE destroy decanter	bottle : o r r o ;
vessel : h ; burette : b e e b a ; urn : f f ; SEPARATE destroy burette	vessel : h ; urn : f f ;
glass : y y ; decanter : c a v ; flask : f f m r r ; SEPARATE destroy flask	glass : y y ; decanter : c a v ;
jug : b ; jar : m ; pitcher : m o m ; jar : m m ; SEPARATE destroy last jar	jug : b ; jar : m ; pitcher : m o m ;
bottle : f a a f ; flagon : m m ; bottle : y y p m p ; SEPARATE destroy flagon	bottle : f a a f ; bottle : y y p m p ;
flask : f f ; thermos : o h v v ; SEPARATE destroy flask	thermos : o h v v ;
jug : m g g b ; thermos : a ; cup : p ; decanter : m ; SEPARATE destroy thermos	jug : m g g b ; cup : p ; decanter : m ;
canister : c ; beaker : r o o ; SEPARATE destroy canister	beaker : r o o ;
thermos : h h ; flagon : m m ; bottle : o e e y ; SEPARATE destroy bottle	thermos : h h ; flagon : m m ;
beaker : f f d h d ; vessel : o h o ; SEPARATE destroy beaker	vessel : o h o ;
jug : p e e m m p ; vessel : o m ; SEPARATE destroy jug	vessel : o m ;
urn : y ; flask : r m e r ; SEPARATE destroy flask	urn : y ;
vessel : v y ; glass : p ; SEPARATE destroy glass	vessel : v y ;
glass : d c d v c v ; urn : v f y v f y ; SEPARATE destroy urn	glass : d c d v c v ;
jar : p p ; jug : h ; mug : h ; thermos : y ; SEPARATE destroy mug	jar : p p ; jug : h ; thermos : y ;
jar : v v a ; jar : b f a f ; SEPARATE destroy first jar	jar : b f a f ;
glass : c e ; mug : d p ; SEPARATE destroy mug	glass : c e ;
cup : r r ; burette : r r ; SEPARATE destroy burette	cup : r r ;
flagon : d h h ; cup : m ; beaker : d ; SEPARATE destroy cup	flagon : d h h ; beaker : d ;
pitcher : o o ; thermos : g v h ; beaker : g d d ; SEPARATE destroy pitcher	thermos : g v h ; beaker : g d d ;
jug : h ; jug : y f f d ; cup : d ; flagon : a a ; SEPARATE destroy first jug	jug : y f f d ; cup : d ; flagon : a a ;
urn : o r o v ; decanter : p ; SEPARATE destroy decanter	urn : o r o v ;
thermos : d d ; cup : a ; SEPARATE destroy cup	thermos : d d ;
jug : h ; bottle : f c f c d ; SEPARATE destroy bottle	jug : h ;
pitcher : y a r r ; pitcher : c d h d c h ; SEPARATE destroy first pitcher	pitcher : c d h d c h ;
jug : m ; beaker : e e ; SEPARATE destroy beaker	jug : m ;
pitcher : g e f e f ; flask : m ; SEPARATE destroy flask	pitcher : g e f e f ;
burette : y y h c ; burette : e e ; burette : p p ; SEPARATE destroy second burette	burette : y y h c ; burette : p p ;
bottle : c c ; jug : c g c g ; SEPARATE destroy bottle	jug : c g c g ;
jug : y d g d y ; pitcher : p d ; SEPARATE destroy pitcher	jug : y d g d y ;
bottle : o o c ; flask : b b h h ; decanter : p p b ; SEPARATE destroy bottle	flask : b b h h ; decanter : p p b ;
glass : r v b b ; pitcher : p p v ; SEPARATE destroy glass	pitcher : p p v ;
canister : p ; mug : d v v y ; flagon : f a f d ; SEPARATE destroy canister	mug : d v v y ; flagon : f a f d ;
decanter : v e c ; jug : r ; SEPARATE destroy jug	decanter : v e c ;
cup : m g v g ; glass : y y ; SEPARATE destroy glass	cup : m g v g ;
cup : b a a ; glass : v v ; SEPARATE destroy cup	glass : v v ;
bottle : m ; flask : c c ; flask : v e y y v ; SEPARATE destroy first flask	bottle : m ; flask : v e y y v ;
glass : a a m ; pitcher : g ; SEPARATE destroy glass	pitcher : g ;
burette : h h ; flask : d y d v v y ; burette : d d ; SEPARATE destroy first burette	flask : d y d v v y ; burette : d d ;
flask : m f a f a ; beaker : y ; thermos : m m ; SEPARATE destroy thermos	flask : m f a f a ; beaker : y ;
bottle : o o ; urn : a v f f ; flagon : h ; flagon : h h ; SEPARATE destroy urn	bottle : o o ; flagon : h ; flagon : h h ;
vessel : p o p o ; jug : e c o ; thermos : o ; SEPARATE destroy jug	vessel : p o p o ; thermos : o ;
vessel : b f b ; jar : v r v ; flask : a a ; SEPARATE destroy vessel	jar : v r v ; flask : a a ;
decanter : d d ; glass : o ; canister : h h ; SEPARATE destroy glass	decanter : d d ; canister : h h ;
decanter : g h h ; canister : c ; thermos : v ; SEPARATE destroy thermos	decanter : g h h ; canister : c ;
thermos : y y f ; decanter : f o ; SEPARATE destroy decanter	thermos : y y f ;
mug : p p ; bottle : r r b g g ; SEPARATE destroy bottle	mug : p p ;
vessel : p r y y r ; flagon : r r ; SEPARATE destroy flagon	vessel : p r y y r ;
urn : b y b ; thermos : p p f ; flagon : v f ; pitcher : m ; SEPARATE destroy thermos	urn : b y b ; flagon : v f ; pitcher : m ;
beaker : g o o g ; cup : r r ; cup : v r y ; SEPARATE destroy last cup	beaker : g o o g ; cup : r r ;
pitcher : b b ; bottle : y c y a a ; urn : v ; SEPARATE destroy bottle	pitcher : b b ; urn : v ;
cup : g b g ; decanter : f a d ; SEPARATE destroy decanter	cup : g b g ;
flask : f f ; cup : c ; SEPARATE destroy flask	cup : c ;
mug : r g ; urn : b h b h ; SEPARATE destroy mug	urn : b h b h ;
jug : y ; beaker : b b ; SEPARATE destroy beaker	jug : y ;
canister : f f d d ; jug : a p ; flask : e o e o ; SEPARATE destroy canister	jug : a p ; flask : e o e o ;
jar : r r ; flagon : f r c f c ; SEPARATE destroy jar	flagon : f r c f c ;
glass : e p p e g ; burette : e e f f ; flagon : v ; SEPARATE destroy flagon	glass : e p p e g ; burette : e e f f ;
burette : y v b y v ; jar : g g ; pitcher : d d v r ; SEPARATE destroy jar	burette : y v b y v ; pitcher : d d v r ;
flask : c d d ; jug : a v v ; SEPARATE destroy flask	jug : a v v ;
glass : y b y ; decanter : c c ; SEPARATE destroy decanter	glass : y b y ;
beaker : e ; beaker : c c p ; SEPARATE destroy first beaker	beaker : c c p ;
cup : b b c ; canister : d d e e ; thermos : m ; SEPARATE destroy canister	cup : b b c ; thermos : m ;
jar : o o ; flask : m ; SEPARATE destroy flask	jar : o o ;
glass : a a ; glass : v p o p ; bottle : c a ; SEPARATE destroy last glass	glass : a a ; bottle : c a ;
bottle : r r e ; flask : m y a y a ; decanter : h f ; SEPARATE destroy bottle	flask : m y a y a ; decanter : h f ;
bottle : r r ; urn : d h h d ; thermos : o v d ; SEPARATE destroy bottle	urn : d h h d ; thermos : o v d ;
jug : r r a ; jug : m m ; SEPARATE destroy last jug	jug : r r a ;
urn : o o ; thermos : b b ; cup : g o g o a ; SEPARATE destroy cup	urn : o o ; thermos : b b ;
jug : m h h v m ; jug : m h ; SEPARATE destroy first jug	jug : m h ;
glass : g ; pitcher : r r p ; canister : f r ; SEPARATE destroy glass	pitcher : r r p ; canister : f r ;
beaker : g ; glass : o ; mug : p f f e p ; burette : a a ; SEPARATE destroy mug	beaker : g ; glass : o ; burette : a a ;
jar : b d m d m ; flask : d e f f e d ; SEPARATE destroy flask	jar : b d m d m ;
vessel : r ; mug : o ; SEPARATE destroy vessel	mug : o ;
mug : c c o v v o ; vessel : b e b y e ; SEPARATE destroy vessel	mug : c c o v v o ;
bottle : f e y e f ; beaker : g c f f c ; flagon : d ; SEPARATE destroy flagon	bottle : f e y e f ; beaker : g c f f c ;
bottle : m b m ; cup : a h ; glass : h r h c ; SEPARATE destroy bottle	cup : a h ; glass : h r h c ;
canister : b ; jug : g g ; decanter : r p p r ; SEPARATE destroy canister	jug : g g ; decanter : r p p r ;
pitcher : r g b ; decanter : p p g g c ; SEPARATE destroy decanter	pitcher : r g b ;
vessel : p y m m ; cup : f f y y ; bottle : g ; SEPARATE destroy cup	vessel : p y m m ; bottle : g ;
burette : v r y v ; urn : m b ; urn : f ; SEPARATE destroy burette	urn : m b ; urn : f ;
bottle : e ; canister : r r v e e ; beaker : d ; SEPARATE destroy bottle	canister : r r v e e ; beaker : d ;
vessel : h y ; mug : h y ; SEPARATE destroy mug	vessel : h y ;
vessel : b c b d ; pitcher : a e ; canister : h g h d ; SEPARATE destroy vessel	pitcher : a e ; canister : h g h d ;
decanter : f o o ; canister : b d d b ; vessel : p e m p ; SEPARATE destroy canister	decanter : f o o ; vessel : p e m p ;
cup : c y g ; glass : d m b ; SEPARATE destroy glass	cup : c y g ;
burette : o f f a a ; vessel : y y ; SEPARATE destroy burette	vessel : y y ;
thermos : a a p r ; glass : v v ; SEPARATE destroy thermos	glass : v v ;
jar : g g ; cup : a a ; SEPARATE destroy jar	cup : a a ;
bottle : p ; cup : b r r ; SEPARATE destroy cup	bottle : p ;
decanter : y ; jar : c o c ; SEPARATE destroy jar	decanter : y ;
canister : r p v p r ; glass : g f d d ; SEPARATE destroy canister	glass : g f d d ;
jug : r ; pitcher : y g g ; SEPARATE destroy jug	pitcher : y g g ;
canister : e ; vessel : f g ; SEPARATE destroy canister	vessel : f g ;
jar : f f r c ; thermos : v f ; jug : h p g g p h ; SEPARATE destroy jug	jar : f f r c ; thermos : v f ;
mug : e e v ; mug : h c g g h ; mug : o g ; SEPARATE destroy first mug	mug : h c g g h ; mug : o g ;
cup : a h f f ; flagon : y v e v y e ; SEPARATE destroy cup	flagon : y v e v y e ;
vessel : d ; flask : p ; SEPARATE destroy flask	vessel : d ;
mug : b b ; glass : r d d v r v ; SEPARATE destroy mug	glass : r d d v r v ;
decanter : a y v y ; bottle : b p g g b p ; thermos : e e ; SEPARATE destroy decanter	bottle : b p g g b p ; thermos : e e ;
cup : y y ; vessel : e e ; decanter : h ; SEPARATE destroy decanter	cup : y y ; vessel : e e ;
bottle : o b f b ; flagon : b b m ; SEPARATE destroy flagon	bottle : o b f b ;
urn : d e d e h ; flagon : g ; SEPARATE destroy urn	flagon : g ;
decanter : e d g ; glass : m d y y m ; beaker : c f f c ; SEPARATE destroy decanter	glass : m d y y m ; beaker : c f f c ;
canister : p o p o m ; vessel : p m v p v ; pitcher : p h ; SEPARATE destroy canister	vessel : p m v p v ; pitcher : p h ;
glass : c c ; glass : h h p ; flask : a ; burette : r r ; SEPARATE destroy second glass	glass : c c ; flask : a ; burette : r r ;
decanter : y d y ; burette : r o v ; flask : y y a c a ; SEPARATE destroy flask	decanter : y d y ; burette : r o v ;
vessel : o a a ; burette : o m c m c ; SEPARATE destroy vessel	burette : o m c m c ;
jug : y y b ; canister : c c ; decanter : c c y a ; SEPARATE destroy decanter	jug : y y b ; canister : c c ;
cup : f ; pitcher : e ; beaker : g h b b h ; flask : a a e ; SEPARATE destroy pitcher	cup : f ; beaker : g h b b h ; flask : a a e ;
jug : g g p ; jug : r v y v r ; SEPARATE destroy second jug	jug : g g p ;
flagon : o y o y ; decanter : y f f m ; SEPARATE destroy decanter	flagon : o y o y ;
thermos : v m g v ; decanter : g b g ; glass : c c ; SEPARATE destroy decanter	thermos : v m g v ; glass : c c ;
urn : y ; jar : f ; vessel : e ; SEPARATE destroy jar	urn : y ; vessel : e ;
urn : g g a d ; glass : y ; canister : o o ; cup : p p ; SEPARATE destroy canister	urn : g g a d ; glass : y ; cup : p p ;
mug : r r ; pitcher : y y ; burette : r r ; SEPARATE destroy mug	pitcher : y y ; burette : r r ;
vessel : r p p ; bottle : f f g c ; vessel : y ; SEPARATE destroy bottle	vessel : r p p ; vessel : y ;
canister : f f b b ; vessel : b g g ; cup : g g ; SEPARATE destroy vessel	canister : f f b b ; cup : g g ;
jar : r r ; mug : v v ; flask : m ; flagon : v e e b ; SEPARATE destroy flask	jar : r r ; mug : v v ; flagon : v e e b ;
bottle : o ; decanter : f d f m ; SEPARATE destroy decanter	bottle : o ;
vessel : a h h d ; burette : o c o c ; flagon : f f c c ; SEPARATE destroy burette	vessel : a h h d ; flagon : f f c c ;
beaker : b ; pitcher : e m y ; jug : y g e ; SEPARATE destroy pitcher	beaker : b ; jug : y g e ;
vessel : p p c ; burette : b ; thermos : e o ; SEPARATE destroy vessel	burette : b ; thermos : e o ;
jug : f p f ; mug : d h d y y ; SEPARATE destroy jug	mug : d h d y y ;
canister : g ; canister : b b ; SEPARATE destroy last canister	canister : g ;
jar : y y o m ; glass : o r m o r ; SEPARATE destroy jar	glass : o r m o r ;
pitcher : c a c g ; decanter : p p ; SEPARATE destroy decanter	pitcher : c a c g ;
vessel : a e o e a ; bottle : b b a ; SEPARATE destroy bottle	vessel : a e o e a ;
canister : b g h ; canister : o o f r r f ; SEPARATE destroy first canister	canister : o o f r r f ;
burette : p p d ; canister : e a ; vessel : r y r ; SEPARATE destroy canister	burette : p p d ; vessel : r y r ;
cup : p p e e g g ; canister : m m e e v ; SEPARATE destroy canister	cup : p p e e g g ;
beaker : e p ; jar : m y y m r ; jar : h ; SEPARATE destroy first jar	beaker : e p ; jar : h ;
flask : b c b m c ; vessel : a d d ; thermos : p b b m ; SEPARATE destroy vessel	flask : b c b m c ; thermos : p b b m ;
vessel : h h ; mug : e e ; SEPARATE destroy vessel	mug : e e ;
pitcher : g g ; burette : o ; SEPARATE destroy burette	pitcher : g g ;
canister : f r r o ; beaker : p p ; pitcher : h ; SEPARATE destroy canister	beaker : p p ; pitcher : h ;
beaker : b b ; bottle : v v ; SEPARATE destroy bottle	beaker : b b ;
flagon : f ; burette : d r r y d y ; SEPARATE destroy flagon	burette : d r r y d y ;
cup : y ; flask : d ; vessel : d d m e ; SEPARATE destroy flask	cup : y ; vessel : d d m e ;
burette : h b a b ; pitcher : m ; burette : y y ; SEPARATE destroy pitcher	burette : h b a b ; burette : y y ;
mug : h g g ; flagon : v v a c ; SEPARATE destroy flagon	mug : h g g ;
vessel : f f ; urn : c c e a ; SEPARATE destroy urn	vessel : f f ;
decanter : v ; canister : d d b ; SEPARATE destroy canister	decanter : v ;
canister : e b b ; thermos : b y o ; flask : c c ; SEPARATE destroy thermos	canister : e b b ; flask : c c ;
flask : c c ; canister : v g e g e ; SEPARATE destroy canister	flask : c c ;
thermos : b b ; canister : e r ; burette : h g h ; SEPARATE destroy thermos	canister : e r ; burette : h g h ;
jar : d d ; pitcher : d o d ; burette : r ; urn : f ; SEPARATE destroy jar	pitcher : d o d ; burette : r ; urn : f ;
vessel : r y r y h ; canister : e o o ; thermos : m m ; SEPARATE destroy canister	vessel : r y r y h ; thermos : m m ;
urn : r r ; flask : b ; flask : m y m ; vessel : e c ; SEPARATE destroy urn	flask : b ; flask : m y m ; vessel : e c ;
bottle : c c d g d ; thermos : b ; decanter : m m y ; SEPARATE destroy bottle	thermos : b ; decanter : m m y ;
cup : e o o f ; bottle : p p b o ; burette : g c c ; SEPARATE destroy cup	bottle : p p b o ; burette : g c c ;
thermos : r b f f b ; decanter : e ; flagon : g g ; SEPARATE destroy thermos	decanter : e ; flagon : g g ;
decanter : d p ; mug : m b b ; burette : d m m d ; SEPARATE destroy mug	decanter : d p ; burette : d m m d ;
cup : a ; glass : b b ; burette : o o ; SEPARATE destroy glass	cup : a ; burette : o o ;
flagon : o o m h ; bottle : f f ; SEPARATE destroy flagon	bottle : f f ;
glass : v ; flagon : h m m ; SEPARATE destroy flagon	glass : v ;
vessel : b a a b ; mug : v ; SEPARATE destroy mug	vessel : b a a b ;
jar : o d d o a a ; bottle : o e e ; SEPARATE destroy jar	bottle : o e e ;
thermos : v v ; beaker : f ; cup : r c r e c ; pitcher : b ; SEPARATE destroy pitcher	thermos : v v ; beaker : f ; cup : r c r e c ;
canister : m o m f ; jug : y ; flask : v v ; decanter : o p ; SEPARATE destroy decanter	canister : m o m f ; jug : y ; flask : v v ;
glass : f ; burette : o v a ; SEPARATE destroy glass	burette : o v a ;
jug : p c m m p ; pitcher : e e ; SEPARATE destroy pitcher	jug : p c m m p ;
flagon : o e o p ; glass : d d r e r ; SEPARATE destroy flagon	glass : d d r e r ;
glass : o d a ; jar : a f f r ; SEPARATE destroy glass	jar : a f f r ;
jug : p b b ; beaker : e e ; pitcher : v ; pitcher : c a c ; SEPARATE destroy beaker	jug : p b b ; pitcher : v ; pitcher : c a c ;
pitcher : g c ; flask : b h h ; SEPARATE destroy pitcher	flask : b h h ;
decanter : c h y y h c ; jug : r r ; SEPARATE destroy jug	decanter : c h y y h c ;
burette : f ; beaker : r r g ; SEPARATE destroy burette	beaker : r r g ;
cup : r g r c c ; mug : o o ; flask : b b ; SEPARATE destroy mug	cup : r g r c c ; flask : b b ;
burette : e g p ; thermos : o p ; jug : y ; SEPARATE destroy jug	burette : e g p ; thermos : o p ;
mug : e d ; flagon : a h h a d ; pitcher : m a m ; SEPARATE destroy flagon	mug : e d ; pitcher : m a m ;
jug : d ; canister : g c c ; mug : o b o ; SEPARATE destroy jug	canister : g c c ; mug : o b o ;
mug : g h ; pitcher : h h ; SEPARATE destroy mug	pitcher : h h ;
thermos : v v m ; bottle : r r ; thermos : h h d ; jar : m ; SEPARATE destroy bottle	thermos : v v m ; thermos : h h d ; jar : m ;
jar : f o f e ; decanter : r e p e p r ; cup : m ; SEPARATE destroy jar	decanter : r e p e p r ; cup : m ;
mug : b m ; pitcher : f m g ; SEPARATE destroy mug	pitcher : f m g ;
urn : h y ; jug : v v f r ; glass : b b ; SEPARATE destroy urn	jug : v v f r ; glass : b b ;
decanter : d d f ; glass : m m v v ; burette : y y ; SEPARATE destroy burette	decanter : d d f ; glass : m m v v ;
canister : v ; thermos : c r r ; SEPARATE destroy canister	thermos : c r r ;
vessel : f f ; urn : h h ; urn : g v d d g v ; SEPARATE destroy vessel	urn : h h ; urn : g v d d g v ;
glass : f f ; flagon : b b g ; bottle : c m m h c h ; SEPARATE destroy glass	flagon : b b g ; bottle : c m m h c h ;
decanter : a g ; mug : b d ; vessel : m d d o ; SEPARATE destroy decanter	mug : b d ; vessel : m d d o ;
vessel : m m d ; decanter : p v p c ; cup : y y e ; SEPARATE destroy vessel	decanter : p v p c ; cup : y y e ;
pitcher : o o ; vessel : y f f ; pitcher : e ; SEPARATE destroy last pitcher	pitcher : o o ; vessel : y f f ;
decanter : o r o r ; decanter : c r r a c ; SEPARATE destroy first decanter	decanter : c r r a c ;
flagon : o y d ; glass : g ; SEPARATE destroy glass	flagon : o y d ;
jar : v h v e h ; urn : b a a b ; mug : d e f ; SEPARATE destroy mug	jar : v h v e h ; urn : b a a b ;
mug : e p e ; cup : a a ; canister : e f d e ; SEPARATE destroy mug	cup : a a ; canister : e f d e ;
vessel : r r ; bottle : y v y v ; glass : f a a c c ; SEPARATE destroy vessel	bottle : y v y v ; glass : f a a c c ;
jug : p r ; jar : f ; glass : e ; SEPARATE destroy jug	jar : f ; glass : e ;
mug : e ; pitcher : m f m ; SEPARATE destroy pitcher	mug : e ;
jug : p p ; flask : f f b ; glass : v ; SEPARATE destroy jug	flask : f f b ; glass : v ;
jar : p ; jar : y y ; SEPARATE destroy first jar	jar : y y ;
urn : e ; pitcher : e e d d ; SEPARATE destroy urn	pitcher : e e d d ;
canister : b h a a h ; cup : o ; decanter : g ; jug : y ; SEPARATE destroy canister	cup : o ; decanter : g ; jug : y ;
flask : g b ; mug : o d d ; flask : y ; SEPARATE destroy first flask	mug : o d d ; flask : y ;
glass : a r r d ; beaker : h v f ; SEPARATE destroy glass	beaker : h v f ;
burette : g e e ; pitcher : c c ; cup : c e e c ; SEPARATE destroy burette	pitcher : c c ; cup : c e e c ;
burette : o ; glass : e ; jar : f a b ; SEPARATE destroy glass	burette : o ; jar : f a b ;
cup : m g ; vessel : o d d ; flask : v v ; jug : a a ; SEPARATE destroy jug	cup : m g ; vessel : o d d ; flask : v v ;
jug : h y h y ; flask : p c p ; SEPARATE destroy jug	flask : p c p ;
vessel : e f m f e ; flask : p ; SEPARATE destroy vessel	flask : p ;
pitcher : g h h g ; canister : p ; SEPARATE destroy canister	pitcher : g h h g ;
glass : v f f v e ; jar : d b b ; SEPARATE destroy glass	jar : d b b ;
bottle : e e p ; pitcher : b f g ; decanter : p v h ; SEPARATE destroy decanter	bottle : e e p ; pitcher : b f g ;
glass : d f f d y ; vessel : f y y ; SEPARATE destroy glass	vessel : f y y ;
canister : p r ; beaker : e b e b ; SEPARATE destroy beaker	canister : p r ;
cup : b b c f ; burette : y o o c ; flagon : c g g e ; SEPARATE destroy burette	cup : b b c f ; flagon : c g g e ;
flask : f d d ; mug : a ; vessel : b g ; SEPARATE destroy mug	flask : f d d ; vessel : b g ;
mug : y ; beaker : d c d ; SEPARATE destroy beaker	mug : y ;
flask : c b b ; glass : e e ; SEPARATE destroy flask	glass : e e ;
glass : y h h ; decanter : p ; vessel : d h d ; SEPARATE destroy decanter	glass : y h h ; vessel : d h d ;
mug : r p ; jug : r g d d ; SEPARATE destroy jug	mug : r p ;
flagon : e e g ; vessel : r r o o h ; SEPARATE destroy flagon	vessel : r r o o h ;
flagon : e a f ; thermos : m ; SEPARATE destroy thermos	flagon : e a f ;
glass : c ; decanter : e r y ; mug : m ; SEPARATE destroy glass	decanter : e r y ; mug : m ;
cup : y ; thermos : e ; thermos : d d ; SEPARATE destroy first thermos	cup : y ; thermos : d d ;
pitcher : f y d y ; thermos : v a v o o ; SEPARATE destroy thermos	pitcher : f y d y ;
vessel : h h f f ; jug : p p o ; thermos : m m b ; SEPARATE destroy jug	vessel : h h f f ; thermos : m m b ;
jug : f y ; burette : v ; SEPARATE destroy burette	jug : f y ;
cup : a f a ; glass : a o a g g ; SEPARATE destroy glass	cup : a f a ;
canister : y y ; glass : y ; canister : a a ; SEPARATE destroy first canister	glass : y ; canister : a a ;
jar : h h ; glass : b b ; mug : d d v ; SEPARATE destroy mug	jar : h h ; glass : b b ;
urn : f f h c ; flask : a a ; SEPARATE destroy urn	flask : a a ;
pitcher : b b p p o ; cup : o ; SEPARATE destroy cup	pitcher : b b p p o ;
cup : g ; decanter : a a ; flask : b b r a r ; SEPARATE destroy decanter	cup : g ; flask : b b r a r ;
canister : f e e f ; jar : h ; mug : d g d g ; SEPARATE destroy jar	canister : f e e f ; mug : d g d g ;
beaker : y m y m ; thermos : p ; flask : b ; SEPARATE destroy thermos	beaker : y m y m ; flask : b ;
thermos : h b ; bottle : m p ; SEPARATE destroy bottle	thermos : h b ;
jug : g g b ; beaker : o o d ; flask : p d p v ; SEPARATE destroy beaker	jug : g g b ; flask : p d p v ;
pitcher : h a ; jug : c c ; SEPARATE destroy pitcher	jug : c c ;
jug : h h e ; flagon : v v r r ; SEPARATE destroy jug	flagon : v v r r ;
mug : e c c ; cup : g ; SEPARATE destroy mug	cup : g ;
glass : y y ; pitcher : c c g ; SEPARATE destroy pitcher	glass : y y ;
flagon : c ; decanter : h ; flask : m ; burette : e ; SEPARATE destroy burette	flagon : c ; decanter : h ; flask : m ;
jar : c ; bottle : f f ; SEPARATE destroy jar	bottle : f f ;
thermos : d f g d g f ; mug : p a ; mug : b a a ; SEPARATE destroy first mug	thermos : d f g d g f ; mug : b a a ;
jar : b ; vessel : a v v ; decanter : d ; SEPARATE destroy jar	vessel : a v v ; decanter : d ;
vessel : y ; beaker : r r a ; glass : h h ; SEPARATE destroy glass	vessel : y ; beaker : r r a ;
decanter : d g g r d r ; jar : y ; canister : g ; SEPARATE destroy decanter	jar : y ; canister : g ;
bottle : v v ; burette : o g m ; SEPARATE destroy burette	bottle : v v ;
flagon : e a ; flask : m m p ; flask : c p e e ; SEPARATE destroy last flask	flagon : e a ; flask : m m p ;
thermos : r r d ; flagon : g g r r ; SEPARATE destroy thermos	flagon : g g r r ;
urn : c f o c ; glass : y p f ; SEPARATE destroy glass	urn : c f o c ;
vessel : o ; urn : o o ; SEPARATE destroy urn	vessel : o ;
thermos : c a f c a ; bottle : a ; mug : r o o ; SEPARATE destroy mug	thermos : c a f c a ; bottle : a ;
urn : e ; jug : b b ; flagon : f v ; SEPARATE destroy jug	urn : e ; flagon : f v ;
burette : v ; pitcher : m m a ; SEPARATE destroy pitcher	burette : v ;
bottle : m h m ; pitcher : o m p o ; SEPARATE destroy pitcher	bottle : m h m ;
decanter : c ; decanter : a c ; SEPARATE destroy last decanter	decanter : c ;
cup : a d a d ; flask : c c v ; mug : h y y h ; SEPARATE destroy mug	cup : a d a d ; flask : c c v ;
burette : o p p ; burette : f r r ; SEPARATE destroy second burette	burette : o p p ;
decanter : h v h y v ; glass : g d v ; SEPARATE destroy glass	decanter : h v h y v ;
bottle : b y b y ; urn : y h h y ; SEPARATE destroy urn	bottle : b y b y ;
pitcher : r a a ; canister : c c r ; decanter : p p ; jug : h ; SEPARATE destroy jug	pitcher : r a a ; canister : c c r ; decanter : p p ;
burette : o d o b ; jug : g g ; mug : g ; burette : y ; SEPARATE destroy mug	burette : o d o b ; jug : g g ; burette : y ;
flagon : c c h o ; burette : d g g d ; SEPARATE destroy burette	flagon : c c h o ;
burette : h h ; jar : y g g o ; flask : g g ; SEPARATE destroy flask	burette : h h ; jar : y g g o ;
vessel : e r c c ; cup : m e m g e ; SEPARATE destroy vessel	cup : m e m g e ;
burette : f c ; thermos : v r v r ; SEPARATE destroy burette	thermos : v r v r ;
glass : p p ; cup : a a ; vessel : g ; SEPARATE destroy cup	glass : p p ; vessel : g ;
cup : g g h ; cup : m o m ; jar : c ; SEPARATE destroy last cup	cup : g g h ; jar : c ;
beaker : e o o e f ; vessel : y y ; urn : v ; SEPARATE destroy urn	beaker : e o o e f ; vessel : y y ;
canister : o g g o f ; burette : v d h v ; SEPARATE destroy burette	canister : o g g o f ;
decanter : f v ; pitcher : f c o f ; SEPARATE destroy pitcher	decanter : f v ;
pitcher : a h a h ; glass : c y c ; urn : b ; SEPARATE destroy glass	pitcher : a h a h ; urn : b ;
beaker : y f ; jar : r e e a ; SEPARATE destroy jar	beaker : y f ;
flagon : p r g g p ; beaker : y y p p ; bottle : f f ; SEPARATE destroy flagon	beaker : y y p p ; bottle : f f ;
burette : f ; mug : m o a o a m ; SEPARATE destroy burette	mug : m o a o a m ;
glass : p g p g e ; glass : f y f ; SEPARATE destroy first glass	glass : f y f ;
pitcher : y o r r o ; beaker : p p ; SEPARATE destroy beaker	pitcher : y o r r o ;
flagon : d ; decanter : v p ; SEPARATE destroy decanter	flagon : d ;
cup : o ; canister : c c ; SEPARATE destroy canister	cup : o ;
beaker : y b b y ; burette : v p o ; SEPARATE destroy burette	beaker : y b b y ;
thermos : b b ; decanter : m m ; SEPARATE destroy thermos	decanter : m m ;
vessel : c c ; decanter : o ; flagon : v ; SEPARATE destroy flagon	vessel : c c ; decanter : o ;
jug : g p g o p ; canister : d d ; flagon : d m m d ; SEPARATE destroy flagon	jug : g p g o p ; canister : d d ;
beaker : d d h v h ; jug : g y m m ; SEPARATE destroy jug	beaker : d d h v h ;
canister : a m h ; cup : f f y y ; SEPARATE destroy canister	cup : f f y y ;
canister : d d f p ; pitcher : c c ; SEPARATE destroy pitcher	canister : d d f p ;
vessel : b b y y ; flagon : r g g f r ; canister : h p p ; SEPARATE destroy flagon	vessel : b b y y ; canister : h p p ;
decanter : y y ; canister : v d v ; vessel : e e d ; SEPARATE destroy canister	decanter : y y ; vessel : e e d ;
mug : c y a a ; glass : y p ; SEPARATE destroy glass	mug : c y a a ;
mug : f f d ; urn : a ; canister : e ; SEPARATE destroy canister	mug : f f d ; urn : a ;
urn : m m y y ; beaker : o b g b ; SEPARATE destroy beaker	urn : m m y y ;
jar : v y ; cup : c c ; mug : v ; SEPARATE destroy jar	cup : c c ; mug : v ;
decanter : p d d p o ; jar : e d d c ; SEPARATE destroy decanter	jar : e d d c ;
canister : d ; jug : r ; burette : o d m m o ; SEPARATE destroy canister	jug : r ; burette : o d m m o ;
jug : c c ; urn : b ; thermos : y y ; cup : g r g ; SEPARATE destroy cup	jug : c c ; urn : b ; thermos : y y ;
jar : d ; flagon : v c o c v ; vessel : g h ; SEPARATE destroy vessel	jar : d ; flagon : v c o c v ;
canister : r ; decanter : v v ; thermos : p p ; burette : p ; SEPARATE destroy thermos	canister : r ; decanter : v v ; burette : p ;
mug : c ; thermos : b ; bottle : h ; SEPARATE destroy thermos	mug : c ; bottle : h ;
decanter : r r c c ; cup : o p o p ; decanter : c d d ; SEPARATE destroy first decanter	cup : o p o p ; decanter : c d d ;
bottle : y ; mug : c c y a y ; SEPARATE destroy mug	bottle : y ;
canister : c c ; jug : e e ; SEPARATE destroy canister	jug : e e ;
jug : e y ; pitcher : a ; vessel : a a ; mug : p ; SEPARATE destroy mug	jug : e y ; pitcher : a ; vessel : a a ;
burette : p ; beaker : v v f f ; flagon : o o ; SEPARATE destroy burette	beaker : v v f f ; flagon : o o ;
flask : o p c p o c ; jar : c m f m ; SEPARATE destroy jar	flask : o p c p o c ;
jar : e e ; bottle : c e f e c ; jar : b b d f ; SEPARATE destroy last jar	jar : e e ; bottle : c e f e c ;
flask : p p d d ; beaker : p f ; SEPARATE destroy flask	beaker : p f ;
mug : y y ; cup : v ; decanter : e e ; pitcher : e y f ; SEPARATE destroy cup	mug : y y ; decanter : e e ; pitcher : e y f ;
vessel : r g g ; burette : e h v ; burette : f f ; SEPARATE destroy last burette	vessel : r g g ; burette : e h v ;
beaker : p p a a m m ; burette : c c ; SEPARATE destroy burette	beaker : p p a a m m ;
vessel : y h ; jar : b c c p p ; SEPARATE destroy jar	vessel : y h ;
bottle : r b e ; flask : c d g ; SEPARATE destroy flask	bottle : r b e ;
flagon : b e ; urn : e v v g g ; thermos : e e r r ; SEPARATE destroy thermos	flagon : b e ; urn : e v v g g ;
urn : h ; bottle : m e e m ; pitcher : f p ; bottle : p r ; SEPARATE destroy urn	bottle : m e e m ; pitcher : f p ; bottle : p r ;
jug : v v ; burette : o o ; pitcher : v g ; beaker : v ; SEPARATE destroy beaker	jug : v v ; burette : o o ; pitcher : v g ;
cup : y ; glass : g c e c ; SEPARATE destroy cup	glass : g c e c ;
vessel : f o f o ; urn : p ; SEPARATE destroy vessel	urn : p ;
burette : e f ; cup : o ; urn : v v g ; SEPARATE destroy urn	burette : e f ; cup : o ;
urn : v h g ; jug : y y ; thermos : a c m a ; SEPARATE destroy urn	jug : y y ; thermos : a c m a ;
decanter : v a a b b ; mug : g a ; thermos : y o o ; SEPARATE destroy decanter	mug : g a ; thermos : y o o ;
urn : v ; beaker : p e ; SEPARATE destroy urn	beaker : p e ;
jar : a f c c f ; vessel : m m ; flask : v m ; SEPARATE destroy flask	jar : a f c c f ; vessel : m m ;
flask : h h y y ; jar : v r ; SEPARATE destroy flask	jar : v r ;
decanter : f c f ; bottle : e c m e c ; SEPARATE destroy decanter	bottle : e c m e c ;
pitcher : a a ; mug : m m ; pitcher : g h ; SEPARATE destroy last pitcher	pitcher : a a ; mug : m m ;
decanter : v b d d ; jar : b f b ; SEPARATE destroy jar	decanter : v b d d ;
burette : v ; mug : g g o o ; SEPARATE destroy mug	burette : v ;
glass : p m o p ; mug : e a f a f ; SEPARATE destroy mug	glass : p m o p ;
flask : p y h h p ; flask : d o ; SEPARATE destroy first flask	flask : d o ;
jug : a a ; urn : a o ; SEPARATE destroy urn	jug : a a ;
flagon : d h ; mug : a e a e h ; SEPARATE destroy mug	flagon : d h ;
jug : h ; cup : c v v p p ; SEPARATE destroy cup	jug : h ;
jug : o g e o ; flask : r ; thermos : d v c v ; SEPARATE destroy flask	jug : o g e o ; thermos : d v c v ;
glass : e ; flask : b f b y ; pitcher : v ; SEPARATE destroy flask	glass : e ; pitcher : v ;
bottle : a c p p ; flask : e v e p p ; jar : c c ; SEPARATE destroy bottle	flask : e v e p p ; jar : c c ;
vessel : o o ; decanter : v r r f v ; vessel : p p ; SEPARATE destroy second vessel	vessel : o o ; decanter : v r r f v ;
bottle : a v c c a ; pitcher : o o ; jug : m c ; SEPARATE destroy bottle	pitcher : o o ; jug : m c ;
burette : b ; jug : a p g a ; SEPARATE destroy burette	jug : a p g a ;
urn : o o ; jar : c y y ; SEPARATE destroy jar	urn : o o ;
mug : h e a h a ; urn : e c e ; bottle : y ; SEPARATE destroy urn	mug : h e a h a ; bottle : y ;
flask : y h y ; mug : e ; SEPARATE destroy flask	mug : e ;
pitcher : b ; cup : b p m p ; flagon : m g g ; SEPARATE destroy flagon	pitcher : b ; cup : b p m p ;
jug : b m b ; pitcher : p p h ; SEPARATE destroy jug	pitcher : p p h ;
burette : e f p ; cup : e r r d ; SEPARATE destroy cup	burette : e f p ;
bottle : m ; canister : b a b a ; SEPARATE destroy bottle	canister : b a b a ;
pitcher : y y ; vessel : y d y o o ; SEPARATE destroy pitcher	vessel : y d y o o ;
beaker : d a a ; vessel : b v d ; SEPARATE destroy vessel	beaker : d a a ;
flagon : h h ; vessel : v o v b ; SEPARATE destroy flagon	vessel : v o v b ;
jar : a r a m r m ; jug : e ; SEPARATE destroy jar	jug : e ;
bottle : y y d p d ; thermos : v ; jar : m m c c ; SEPARATE destroy thermos	bottle : y y d p d ; jar : m m c c ;
bottle : b e y e ; decanter : f f ; burette : o r o ; SEPARATE destroy bottle	decanter : f f ; burette : o r o ;
vessel : f ; bottle : r e ; SEPARATE destroy vessel	bottle : r e ;
mug : h ; urn : d ; canister : h h ; SEPARATE destroy mug	urn : d ; canister : h h ;
bottle : b b ; canister : o d ; beaker : d d a e a ; SEPARATE destroy bottle	canister : o d ; beaker : d d a e a ;
decanter : v ; vessel : a e h e a ; canister : p ; SEPARATE destroy decanter	vessel : a e h e a ; canister : p ;
pitcher : d g d r g ; cup : h o h ; SEPARATE destroy cup	pitcher : d g d r g ;
urn : v ; decanter : y v ; SEPARATE destroy urn	decanter : y v ;
flagon : f f v ; decanter : b e e m ; SEPARATE destroy flagon	decanter : b e e m ;
beaker : c a a c ; flagon : m m ; SEPARATE destroy flagon	beaker : c a a c ;
flagon : d v f d ; mug : o m ; SEPARATE destroy mug	flagon : d v f d ;
canister : e ; glass : a o y ; urn : g ; SEPARATE destroy urn	canister : e ; glass : a o y ;
vessel : h ; vessel : g g v v ; SEPARATE destroy second vessel	vessel : h ;
glass : o o ; bottle : y m m ; SEPARATE destroy glass	bottle : y m m ;
burette : a r ; mug : d c d ; urn : y ; vessel : h ; SEPARATE destroy mug	burette : a r ; urn : y ; vessel : h ;
burette : v y v ; cup : h b b h ; SEPARATE destroy cup	burette : v y v ;
urn : f f ; jug : e h e h ; SEPARATE destroy urn	jug : e h e h ;
flagon : r o r ; jar : d ; flask : e r a e a ; SEPARATE destroy flask	flagon : r o r ; jar : d ;
canister : a d d f ; flagon : v v c c ; SEPARATE destroy canister	flagon : v v c c ;
beaker : f ; cup : b v g ; SEPARATE destroy cup	beaker : f ;
cup : y y e e ; mug : p v ; SEPARATE destroy mug	cup : y y e e ;
flagon : g e g e b ; jug : b c m b m c ; SEPARATE destroy flagon	jug : b c m b m c ;
canister : r ; flagon : b p ; SEPARATE destroy canister	flagon : b p ;
pitcher : a ; urn : b ; SEPARATE destroy pitcher	urn : b ;
flagon : a ; jug : v ; SEPARATE destroy flagon	jug : v ;
glass : d d v m v m ; jar : v ; SEPARATE destroy jar	glass : d d v m v m ;
burette : f f ; jug : d ; burette : r r ; urn : a a ; SEPARATE destroy jug	burette : f f ; burette : r r ; urn : a a ;
mug : y o c y o ; thermos : y d y d b ; jug : r ; SEPARATE destroy jug	mug : y o c y o ; thermos : y d y d b ;
canister : v v ; urn : m m ; SEPARATE destroy urn	canister : v v ;
glass : b p e e ; urn : a a e ; SEPARATE destroy glass	urn : a a e ;
thermos : o f c f o ; bottle : h c h c ; SEPARATE destroy bottle	thermos : o f c f o ;
canister : p p f ; jar : b ; SEPARATE destroy jar	canister : p p f ;
jar : a ; bottle : o o ; decanter : p e p e ; SEPARATE destroy bottle	jar : a ; decanter : p e p e ;
pitcher : g ; cup : b c b p p c ; SEPARATE destroy pitcher	cup : b c b p p c ;
burette : d p r ; jug : m y e m ; canister : b c b ; SEPARATE destroy burette	jug : m y e m ; canister : b c b ;
bottle : a a ; flagon : o h d o d ; SEPARATE destroy bottle	flagon : o h d o d ;
flask : f ; burette : g ; SEPARATE destroy burette	flask : f ;
urn : r b r ; bottle : g g ; pitcher : h a a ; flagon : d ; SEPARATE destroy bottle	urn : r b r ; pitcher : h a a ; flagon : d ;
flagon : o o a ; jar : y y o h ; SEPARATE destroy jar	flagon : o o a ;
vessel : r r b p b p ; pitcher : m m a p ; SEPARATE destroy vessel	pitcher : m m a p ;
thermos : b o ; vessel : o a ; mug : c f y y ; SEPARATE destroy vessel	thermos : b o ; mug : c f y y ;
jar : y b y ; burette : c p h ; SEPARATE destroy burette	jar : y b y ;
jar : p g b ; urn : f h ; decanter : g ; SEPARATE destroy urn	jar : p g b ; decanter : g ;
jar : p b b p ; jar : f ; cup : y r o ; SEPARATE destroy first jar	jar : f ; cup : y r o ;
urn : g ; pitcher : d ; beaker : o ; SEPARATE destroy urn	pitcher : d ; beaker : o ;
flask : m ; mug : o ; jar : f e f m e ; urn : p p ; SEPARATE destroy mug	flask : m ; jar : f e f m e ; urn : p p ;
glass : v a p ; flagon : r r f ; SEPARATE destroy glass	flagon : r r f ;
canister : v p v r p ; flask : e e y y ; SEPARATE destroy canister	flask : e e y y ;
thermos : h p p ; decanter : f f ; pitcher : f d d f ; SEPARATE destroy decanter	thermos : h p p ; pitcher : f d d f ;
flask : r r p h ; jug : p p c ; SEPARATE destroy jug	flask : r r p h ;
canister : f f ; canister : d d ; SEPARATE destroy last canister	canister : f f ;
flask : o ; jar : c r g r ; SEPARATE destroy flask	jar : c r g r ;
cup : f f ; vessel : e e ; SEPARATE destroy vessel	cup : f f ;
urn : m m b b ; thermos : g c ; SEPARATE destroy urn	thermos : g c ;
flagon : b b f p ; canister : r r ; SEPARATE destroy canister	flagon : b b f p ;
flagon : m m ; beaker : o o c c ; pitcher : d ; bottle : c ; SEPARATE destroy flagon	beaker : o o c c ; pitcher : d ; bottle : c ;
mug : e h e ; mug : a ; jug : g v ; SEPARATE destroy last mug	mug : e h e ; jug : g v ;
jar : a d h d ; canister : y a ; flagon : a b a ; SEPARATE destroy flagon	jar : a d h d ; canister : y a ;
bottle : p f p f ; burette : a v a ; SEPARATE destroy burette	bottle : p f p f ;
jar : m v m ; mug : y a b b a ; flask : a o ; SEPARATE destroy jar	mug : y a b b a ; flask : a o ;
decanter : g f e g ; decanter : c ; SEPARATE destroy first decanter	decanter : c ;
jug : c f c f g ; burette : y y p b b ; SEPARATE destroy jug	burette : y y p b b ;
flask : y a a y ; canister : m m e ; SEPARATE destroy flask	canister : m m e ;
decanter : d e d p ; mug : r m ; decanter : o y o ; SEPARATE destroy first decanter	mug : r m ; decanter : o y o ;
decanter : e d p e ; flagon : m m ; mug : m f v f v ; SEPARATE destroy flagon	decanter : e d p e ; mug : m f v f v ;
pitcher : d d ; bottle : v g ; canister : p p ; SEPARATE destroy canister	pitcher : d d ; bottle : v g ;
decanter : c c ; cup : p ; vessel : f f p ; SEPARATE destroy decanter	cup : p ; vessel : f f p ;
beaker : g f p ; bottle : g g r b b ; SEPARATE destroy beaker	bottle : g g r b b ;
jug : b e b ; mug : h h ; mug : r ; SEPARATE destroy second mug	jug : b e b ; mug : h h ;
cup : d ; bottle : b r y ; SEPARATE destroy cup	bottle : b r y ;
flask : c ; mug : r h h p ; bottle : e f v f v e ; SEPARATE destroy bottle	flask : c ; mug : r h h p ;
burette : m m ; decanter : d r r c ; SEPARATE destroy decanter	burette : m m ;
jar : f o m m ; thermos : e r ; SEPARATE destroy jar	thermos : e r ;
urn : y h y ; bottle : g a a ; SEPARATE destroy urn	bottle : g a a ;
glass : c ; jar : r r ; SEPARATE destroy jar	glass : c ;
beaker : h m h ; cup : g ; SEPARATE destroy beaker	cup : g ;
flask : p f f ; vessel : e r e v r ; SEPARATE destroy flask	vessel : e r e v r ;
mug : c h ; bottle : e e ; flagon : h c c h ; SEPARATE destroy bottle	mug : c h ; flagon : h c c h ;
burette : g d d a ; bottle : a h h p ; SEPARATE destroy burette	bottle : a h h p ;
bottle : r m r ; vessel : g g c c ; jug : g ; SEPARATE destroy bottle	vessel : g g c c ; jug : g ;
glass : g ; jug : c b b r r ; burette : c ; SEPARATE destroy burette	glass : g ; jug : c b b r r ;
urn : d o e d o ; pitcher : g b g ; cup : h ; SEPARATE destroy pitcher	urn : d o e d o ; cup : h ;
jar : y c c y ; pitcher : a a ; SEPARATE destroy jar	pitcher : a a ;
decanter : p ; cup : p ; beaker : m ; SEPARATE destroy decanter	cup : p ; beaker : m ;
decanter : f f ; vessel : g d ; bottle : b p b ; SEPARATE destroy decanter	vessel : g d ; bottle : b p b ;
thermos : c o ; pitcher : h h ; SEPARATE destroy pitcher	thermos : c o ;
urn : c ; mug : o m ; pitcher : d ; SEPARATE destroy mug	urn : c ; pitcher : d ;
mug : f f ; urn : r b g r b g ; SEPARATE destroy mug	urn : r b g r b g ;
urn : g ; jug : h o g g ; SEPARATE destroy jug	urn : g ;
flagon : g h v ; canister : b e g e ; jar : b m m b ; SEPARATE destroy canister	flagon : g h v ; jar : b m m b ;
flask : r g g ; mug : g p c p ; thermos : o m ; SEPARATE destroy thermos	flask : r g g ; mug : g p c p ;
jar : r h r ; beaker : a c a ; SEPARATE destroy beaker	jar : r h r ;
glass : e b f e f ; jar : y y ; SEPARATE destroy glass	jar : y y ;
vessel : b b ; flagon : p p o m o m ; pitcher : g e ; SEPARATE destroy flagon	vessel : b b ; pitcher : g e ;
bottle : y v ; urn : y o y o ; pitcher : r p ; SEPARATE destroy pitcher	bottle : y v ; urn : y o y o ;
jar : r r ; vessel : y r r d y d ; cup : o b ; SEPARATE destroy cup	jar : r r ; vessel : y r r d y d ;
decanter : e e ; flagon : r p ; bottle : e r r e p ; SEPARATE destroy decanter	flagon : r p ; bottle : e r r e p ;
mug : h m y ; flask : p p g ; SEPARATE destroy mug	flask : p p g ;
beaker : r r ; jar : f d v d ; SEPARATE destroy jar	beaker : r r ;
jar : b ; thermos : g ; flagon : r o o r a ; SEPARATE destroy flagon	jar : b ; thermos : g ;
bottle : h a h a ; burette : p g ; SEPARATE destroy bottle	burette : p g ;
glass : g y y ; thermos : m ; SEPARATE destroy glass	thermos : m ;
flask : b g b ; flask : f o ; SEPARATE destroy first flask	flask : f o ;
jar : y g a y ; jar : c c ; SEPARATE destroy second jar	jar : y g a y ;
beaker : r d d r p p ; bottle : p p ; jar : e e m a ; SEPARATE destroy beaker	bottle : p p ; jar : e e m a ;
thermos : h a h a ; thermos : h h a e ; cup : r ; SEPARATE destroy last thermos	thermos : h a h a ; cup : r ;
bottle : e v c c ; decanter : g v o o g ; vessel : h h o ; SEPARATE destroy vessel	bottle : e v c c ; decanter : g v o o g ;
thermos : g ; burette : c c ; urn : v ; flask : m m c c ; SEPARATE destroy burette	thermos : g ; urn : v ; flask : m m c c ;
thermos : y ; glass : m v d v d ; mug : g f f g ; SEPARATE destroy thermos	glass : m v d v d ; mug : g f f g ;
pitcher : f d d f ; burette : y m v v ; vessel : e c c ; SEPARATE destroy pitcher	burette : y m v v ; vessel : e c c ;
vessel : c o o ; jug : r r ; SEPARATE destroy vessel	jug : r r ;
jar : r b b m ; decanter : h o o ; burette : p h p ; SEPARATE destroy decanter	jar : r b b m ; burette : p h p ;
cup : o ; flagon : d d c c ; cup : m a m a ; SEPARATE destroy first cup	flagon : d d c c ; cup : m a m a ;
beaker : m p m b ; jug : d e e f ; SEPARATE destroy jug	beaker : m p m b ;
jar : o b d d o ; urn : r b p r ; burette : a p p ; SEPARATE destroy burette	jar : o b d d o ; urn : r b p r ;
jar : o f a a ; burette : b p b ; bottle : e e ; pitcher : g ; SEPARATE destroy jar	burette : b p b ; bottle : e e ; pitcher : g ;
flagon : v ; vessel : m f m ; SEPARATE destroy flagon	vessel : m f m ;
cup : d d p g p ; beaker : m m ; burette : r r g ; SEPARATE destroy cup	beaker : m m ; burette : r r g ;
canister : a r a r ; mug : c b b c p ; SEPARATE destroy mug	canister : a r a r ;
thermos : f y y a ; burette : g g ; flagon : v f d v ; SEPARATE destroy thermos	burette : g g ; flagon : v f d v ;
thermos : h y h ; burette : a ; SEPARATE destroy thermos	burette : a ;
urn : d b ; cup : m o ; cup : e ; vessel : p f d ; SEPARATE destroy urn	cup : m o ; cup : e ; vessel : p f d ;
vessel : p f ; cup : a a ; SEPARATE destroy vessel	cup : a a ;
decanter : h h a ; vessel : m ; urn : b a ; SEPARATE destroy urn	decanter : h h a ; vessel : m ;
jar : h p p ; beaker : r ; SEPARATE destroy jar	beaker : r ;
jar : r o b r b ; burette : a y y r a ; SEPARATE destroy burette	jar : r o b r b ;
decanter : p p ; flagon : h d ; jug : f e a ; SEPARATE destroy flagon	decanter : p p ; jug : f e a ;
cup : y r r e ; mug : y b y ; SEPARATE destroy mug	cup : y r r e ;
jar : h h g g e ; jug : h m h ; jar : v ; SEPARATE destroy second jar	jar : h h g g e ; jug : h m h ;
cup : m a a ; pitcher : v a a e ; SEPARATE destroy cup	pitcher : v a a e ;
canister : r g y ; urn : y r v v ; flask : p d d ; SEPARATE destroy urn	canister : r g y ; flask : p d d ;
bottle : y c r y ; pitcher : o ; SEPARATE destroy pitcher	bottle : y c r y ;
flagon : m ; jar : v ; SEPARATE destroy flagon	jar : v ;
vessel : h p h ; mug : r f ; SEPARATE destroy vessel	mug : r f ;
vessel : h d d h b ; pitcher : b a a ; pitcher : b o o ; SEPARATE destroy first pitcher	vessel : h d d h b ; pitcher : b o o ;
bottle : v p ; jug : a ; SEPARATE destroy jug	bottle : v p ;
burette : p f p ; mug : e ; SEPARATE destroy burette	mug : e ;
urn : y p a y ; burette : g g b b o ; SEPARATE destroy urn	burette : g g b b o ;
bottle : o e f ; urn : c c ; vessel : y ; SEPARATE destroy vessel	bottle : o e f ; urn : c c ;
cup : a a ; urn : d d ; decanter : f c o ; glass : g g ; SEPARATE destroy decanter	cup : a a ; urn : d d ; glass : g g ;
thermos : m m ; canister : r g g e ; burette : e e m ; SEPARATE destroy thermos	canister : r g g e ; burette : e e m ;
beaker : f p m p m ; burette : d f d ; SEPARATE destroy burette	beaker : f p m p m ;
glass : d d g ; canister : p ; SEPARATE destroy glass	canister : p ;
canister : c b b ; urn : m b m ; SEPARATE destroy canister	urn : m b m ;
decanter : h d h f ; pitcher : h c ; SEPARATE destroy pitcher	decanter : h d h f ;
thermos : y y ; flask : g c p c ; urn : o a a o ; SEPARATE destroy urn	thermos : y y ; flask : g c p c ;
thermos : p e o e ; jug : o o ; beaker : d d ; SEPARATE destroy thermos	jug : o o ; beaker : d d ;
canister : r m ; flagon : r b r o ; SEPARATE destroy flagon	canister : r m ;
beaker : m m f f ; mug : b c ; glass : g d m ; SEPARATE destroy mug	beaker : m m f f ; glass : g d m ;
pitcher : a b v ; cup : m g ; SEPARATE destroy cup	pitcher : a b v ;
vessel : d d p p ; urn : p d p c c ; canister : a ; SEPARATE destroy urn	vessel : d d p p ; canister : a ;
thermos : o f ; cup : m m o ; beaker : e ; SEPARATE destroy beaker	thermos : o f ; cup : m m o ;
thermos : o ; glass : c o d ; bottle : g g ; SEPARATE destroy glass	thermos : o ; bottle : g g ;
jug : a ; canister : e y e ; SEPARATE destroy canister	jug : a ;
glass : a p ; urn : d f ; mug : h g ; SEPARATE destroy glass	urn : d f ; mug : h g ;
bottle : f b b ; pitcher : e ; beaker : c ; jug : b ; SEPARATE destroy beaker	bottle : f b b ; pitcher : e ; jug : b ;
canister : y y ; cup : e ; flagon : m g g ; SEPARATE destroy flagon	canister : y y ; cup : e ;
vessel : m m ; thermos : f f h ; SEPARATE destroy thermos	vessel : m m ;
canister : g ; vessel : v y h h v ; SEPARATE destroy canister	vessel : v y h h v ;
flagon : y y ; canister : r r ; thermos : b b f f r ; SEPARATE destroy flagon	canister : r r ; thermos : b b f f r ;
flagon : c c b ; pitcher : y ; SEPARATE destroy flagon	pitcher : y ;
flagon : d d ; bottle : b e ; flask : y ; burette : b v ; SEPARATE destroy bottle	flagon : d d ; flask : y ; burette : b v ;
mug : d c d c ; vessel : d ; SEPARATE destroy vessel	mug : d c d c ;
glass : r r ; mug : o ; SEPARATE destroy mug	glass : r r ;
urn : p c c r ; jug : v b b h ; urn : g g ; SEPARATE destroy second urn	urn : p c c r ; jug : v b b h ;
pitcher : e ; vessel : y y a ; SEPARATE destroy vessel	pitcher : e ;
jar : o ; thermos : a o a b ; flask : b ; canister : d b b ; SEPARATE destroy thermos	jar : o ; flask : b ; canister : d b b ;
flagon : v v p o ; thermos : c p c ; decanter : r f a f ; SEPARATE destroy thermos	flagon : v v p o ; decanter : r f a f ;
jug : y o ; decanter : p c ; SEPARATE destroy decanter	jug : y o ;
thermos : a g a ; jug : d e y d e y ; glass : f f ; SEPARATE destroy glass	thermos : a g a ; jug : d e y d e y ;
canister : o p e o ; glass : m f f o ; SEPARATE destroy glass	canister : o p e o ;
thermos : p p ; urn : y o ; jar : b ; flask : p v v p ; SEPARATE destroy thermos	urn : y o ; jar : b ; flask : p v v p ;
canister : g a g ; urn : f f ; flask : f b f ; SEPARATE destroy urn	canister : g a g ; flask : f b f ;
bottle : e e g ; burette : m m e e ; SEPARATE destroy bottle	burette : m m e e ;
bottle : a ; flask : a v a ; flagon : c ; mug : h ; SEPARATE destroy bottle	flask : a v a ; flagon : c ; mug : h ;
vessel : m m ; flagon : a a e r ; SEPARATE destroy vessel	flagon : a a e r ;
beaker : c c e r ; thermos : p p ; SEPARATE destroy thermos	beaker : c c e r ;
jug : b ; jug : p ; decanter : m m ; SEPARATE destroy first jug	jug : p ; decanter : m m ;
vessel : c c ; flask : d g e e ; jug : o m o ; SEPARATE destroy flask	vessel : c c ; jug : o m o ;
decanter : c y o o ; thermos : f f r m m ; SEPARATE destroy thermos	decanter : c y o o ;
pitcher : b ; urn : y y ; SEPARATE destroy urn	pitcher : b ;
urn : f m f ; flagon : v v ; pitcher : a a ; SEPARATE destroy pitcher	urn : f m f ; flagon : v v ;
jug : m m ; jug : f c f c ; jug : f f a a ; SEPARATE destroy first jug	jug : f c f c ; jug : f f a a ;
jar : c ; canister : o o d ; decanter : c d d ; SEPARATE destroy jar	canister : o o d ; decanter : c d d ;
cup : f f c ; jar : m f ; SEPARATE destroy jar	cup : f f c ;
burette : f ; pitcher : d v v ; SEPARATE destroy burette	pitcher : d v v ;
canister : p p o a o ; decanter : h b v v b h ; SEPARATE destroy canister	decanter : h b v v b h ;
beaker : e ; canister : c e c y y ; SEPARATE destroy canister	beaker : e ;
canister : a a ; bottle : a a ; SEPARATE destroy bottle	canister : a a ;
thermos : r ; urn : f ; bottle : p ; cup : d d ; SEPARATE destroy bottle	thermos : r ; urn : f ; cup : d d ;
thermos : m v g g ; flagon : p ; SEPARATE destroy flagon	thermos : m v g g ;
mug : f o e ; flask : v d ; jug : f o v v f ; SEPARATE destroy flask	mug : f o e ; jug : f o v v f ;
mug : m c c m ; vessel : b b f ; SEPARATE destroy mug	vessel : b b f ;
jug : h h y y ; thermos : b ; SEPARATE destroy jug	thermos : b ;
beaker : y a y ; bottle : h h ; vessel : h h r r ; SEPARATE destroy bottle	beaker : y a y ; vessel : h h r r ;
canister : p r p ; cup : a a r h h r ; glass : a ; SEPARATE destroy glass	canister : p r p ; cup : a a r h h r ;
thermos : p g ; mug : d y f f ; flagon : y ; flagon : d ; SEPARATE destroy first flagon	thermos : p g ; mug : d y f f ; flagon : d ;
beaker : b o o ; decanter : h h ; urn : d b d b p ; SEPARATE destroy beaker	decanter : h h ; urn : d b d b p ;
decanter : e y e y ; vessel : y g d y g ; SEPARATE destroy vessel	decanter : e y e y ;
thermos : g g d ; flagon : y v y h v ; urn : o h h ; SEPARATE destroy thermos	flagon : y v y h v ; urn : o h h ;
urn : g g o d o d ; vessel : a a ; SEPARATE destroy urn	vessel : a a ;
burette : a e e ; jug : g g ; SEPARATE destroy burette	jug : g g ;
glass : m e h ; mug : f ; SEPARATE destroy glass	mug : f ;
decanter : o o y ; jar : m ; SEPARATE destroy jar	decanter : o o y ;
pitcher : m m ; urn : o ; SEPARATE destroy pitcher	urn : o ;
urn : p h p h ; jar : h v y v h ; glass : o o y ; SEPARATE destroy jar	urn : p h p h ; glass : o o y ;
mug : h e m ; glass : o v r ; jug : e e b b ; SEPARATE destroy mug	glass : o v r ; jug : e e b b ;
urn : b p b f ; urn : m m ; SEPARATE destroy last urn	urn : b p b f ;
urn : f v m f ; bottle : o c c o ; cup : p ; SEPARATE destroy cup	urn : f v m f ; bottle : o c c o ;
thermos : v v ; pitcher : g ; flask : d o d ; pitcher : p ; SEPARATE destroy first pitcher	thermos : v v ; flask : d o d ; pitcher : p ;
beaker : p m d p ; glass : a a c c ; SEPARATE destroy glass	beaker : p m d p ;
bottle : v e v ; mug : e f f o o ; decanter : g g b b ; SEPARATE destroy decanter	bottle : v e v ; mug : e f f o o ;
jug : v v ; cup : v m m ; SEPARATE destroy cup	jug : v v ;
burette : f c c ; canister : e d r r e ; thermos : g r ; SEPARATE destroy canister	burette : f c c ; thermos : g r ;
flagon : d r v d v ; jar : g b ; burette : m y y ; SEPARATE destroy flagon	jar : g b ; burette : m y y ;
cup : y ; beaker : r ; SEPARATE destroy cup	beaker : r ;
cup : m m e c e ; pitcher : p p ; SEPARATE destroy cup	pitcher : p p ;
jar : h h o ; flask : p ; flask : y g y ; SEPARATE destroy last flask	jar : h h o ; flask : p ;
thermos : d d ; thermos : p p m m d ; SEPARATE destroy first thermos	thermos : p p m m d ;
glass : b d r r b d ; flask : a a v ; SEPARATE destroy glass	flask : a a v ;
jug : g v g b ; jar : f m f m ; beaker : d d f ; SEPARATE destroy jar	jug : g v g b ; beaker : d d f ;
cup : r e e p r ; cup : m ; SEPARATE destroy first cup	cup : m ;
jar : o o ; burette : o o d ; vessel : o o ; SEPARATE destroy vessel	jar : o o ; burette : o o d ;
burette : c c ; bottle : y c c r y ; SEPARATE destroy bottle	burette : c c ;
jar : r r ; vessel : o o ; beaker : f f ; SEPARATE destroy vessel	jar : r r ; beaker : f f ;
thermos : a ; flagon : b g b ; SEPARATE destroy thermos	flagon : b g b ;
bottle : m y m v y ; flask : c m m ; SEPARATE destroy bottle	flask : c m m ;
bottle : g v g v ; glass : c ; SEPARATE destroy bottle	glass : c ;
urn : d p d c ; mug : m ; cup : v v ; glass : a ; SEPARATE destroy cup	urn : d p d c ; mug : m ; glass : a ;
bottle : c ; flask : d o d o a ; burette : g b g o ; SEPARATE destroy bottle	flask : d o d o a ; burette : g b g o ;
decanter : m r r ; mug : m ; jug : y y d d ; pitcher : h ; SEPARATE destroy mug	decanter : m r r ; jug : y y d d ; pitcher : h ;
beaker : d ; vessel : f h h ; SEPARATE destroy beaker	vessel : f h h ;
burette : g y a y ; mug : v v ; jar : g y o o ; SEPARATE destroy mug	burette : g y a y ; jar : g y o o ;
canister : c m r c ; flask : c c ; glass : v r h h ; SEPARATE destroy flask	canister : c m r c ; glass : v r h h ;
thermos : r r ; flagon : d d m c m ; cup : d ; SEPARATE destroy flagon	thermos : r r ; cup : d ;
cup : a a v v ; flagon : o o r a r ; bottle : r ; SEPARATE destroy cup	flagon : o o r a r ; bottle : r ;
pitcher : m ; canister : f f h h ; SEPARATE destroy canister	pitcher : m ;
vessel : r h r h ; bottle : d ; beaker : c c g ; SEPARATE destroy bottle	vessel : r h r h ; beaker : c c g ;
decanter : e r r ; flask : e g y e ; SEPARATE destroy decanter	flask : e g y e ;
thermos : r g r ; flask : e ; jug : v v ; jar : c ; SEPARATE destroy thermos	flask : e ; jug : v v ; jar : c ;
glass : m b g g ; flask : f ; SEPARATE destroy glass	flask : f ;
thermos : e h e ; glass : a a ; SEPARATE destroy glass	thermos : e h e ;
pitcher : m e p p e ; mug : y f g y g ; SEPARATE destroy pitcher	mug : y f g y g ;
mug : a ; jar : f f ; SEPARATE destroy jar	mug : a ;
glass : m ; cup : a a ; canister : g r r ; SEPARATE destroy glass	cup : a a ; canister : g r r ;
flagon : b v v ; canister : m m c ; SEPARATE destroy flagon	canister : m m c ;
bottle : b ; glass : h ; SEPARATE destroy glass	bottle : b ;
flagon : c ; cup : o ; urn : a ; urn : e e ; SEPARATE destroy last urn	flagon : c ; cup : o ; urn : a ;
cup : p y p g g ; canister : o o ; thermos : o v o d v ; SEPARATE destroy canister	cup : p y p g g ; thermos : o v o d v ;
canister : d ; jug : y ; decanter : d d ; urn : d ; SEPARATE destroy canister	jug : y ; decanter : d d ; urn : d ;
urn : y c a ; jug : r h h e r ; SEPARATE destroy jug	urn : y c a ;
thermos : c ; thermos : m v v h m h ; SEPARATE destroy first thermos	thermos : m v v h m h ;
flask : f h f ; jug : c d o c d ; SEPARATE destroy jug	flask : f h f ;
beaker : g g ; jar : o ; SEPARATE destroy beaker	jar : o ;
glass : c d ; urn : p p h ; SEPARATE destroy urn	glass : c d ;
glass : o h m ; beaker : o b e b o ; decanter : m o m h ; SEPARATE destroy glass	beaker : o b e b o ; decanter : m o m h ;
flask : f f r ; pitcher : f p f ; SEPARATE destroy flask	pitcher : f p f ;
pitcher : d ; jug : o o c ; SEPARATE destroy jug	pitcher : d ;
flagon : m m r e ; flagon : p ; SEPARATE destroy last flagon	flagon : m m r e ;
urn : g m m ; bottle : b ; SEPARATE destroy bottle	urn : g m m ;
beaker : h p f ; jar : p ; SEPARATE destroy beaker	jar : p ;
canister : h g h g ; flagon : o ; cup : y ; thermos : m ; SEPARATE destroy cup	canister : h g h g ; flagon : o ; thermos : m ;
urn : a p a ; thermos : d f p ; cup : v d f d ; SEPARATE destroy urn	thermos : d f p ; cup : v d f d ;
thermos : r g r g ; cup : b g g b ; SEPARATE destroy thermos	cup : b g g b ;
thermos : y ; bottle : m ; jar : c v v g c ; SEPARATE destroy jar	thermos : y ; bottle : m ;
flask : f y h h f ; flagon : y y ; thermos : e ; SEPARATE destroy flask	flagon : y y ; thermos : e ;
beaker : h ; flask : p m f m p ; SEPARATE destroy flask	beaker : h ;
vessel : v ; decanter : v e v e g ; SEPARATE destroy vessel	decanter : v e v e g ;
canister : d d ; jug : f d ; beaker : e e c ; thermos : p d ; SEPARATE destroy jug	canister : d d ; beaker : e e c ; thermos : p d ;
bottle : o o ; decanter : g e ; beaker : h r h o ; SEPARATE destroy beaker	bottle : o o ; decanter : g e ;
beaker : e a e ; burette : v o o v a ; SEPARATE destroy burette	beaker : e a e ;
flagon : b d h ; beaker : r r p o o ; SEPARATE destroy beaker	flagon : b d h ;
vessel : a a ; burette : v a v p ; SEPARATE destroy burette	vessel : a a ;
bottle : o o ; pitcher : o d d ; decanter : m b b m ; SEPARATE destroy bottle	pitcher : o d d ; decanter : m b b m ;
decanter : d d y ; jug : r ; decanter : h e e v v ; SEPARATE destroy jug	decanter : d d y ; decanter : h e e v v ;
jar : a ; pitcher : p p ; SEPARATE destroy jar	pitcher : p p ;
cup : o ; bottle : d r m m ; beaker : g g ; SEPARATE destroy bottle	cup : o ; beaker : g g ;
urn : p ; urn : a m ; flask : c o c ; mug : p p ; SEPARATE destroy mug	urn : p ; urn : a m ; flask : c o c ;
flagon : b f c f b ; beaker : m f m ; SEPARATE destroy flagon	beaker : m f m ;
flagon : c r a a c ; jug : b b ; SEPARATE destroy flagon	jug : b b ;
mug : y a y h a h ; glass : f a g ; SEPARATE destroy mug	glass : f a g ;
decanter : h h b ; pitcher : r r ; beaker : g ; flagon : h y ; SEPARATE destroy flagon	decanter : h h b ; pitcher : r r ; beaker : g ;
beaker : v p ; flask : e ; glass : d m y d y ; thermos : d ; SEPARATE destroy glass	beaker : v p ; flask : e ; thermos : d ;
cup : f ; thermos : c c ; SEPARATE destroy cup	thermos : c c ;
bottle : o ; flask : e m ; flask : v d h d h ; SEPARATE destroy last flask	bottle : o ; flask : e m ;
jar : p v d ; thermos : y y ; SEPARATE destroy jar	thermos : y y ;
jar : y m v ; cup : o m y o ; SEPARATE destroy jar	cup : o m y o ;
pitcher : r ; pitcher : h ; SEPARATE destroy first pitcher	pitcher : h ;
vessel : v ; thermos : a h b ; SEPARATE destroy thermos	vessel : v ;
thermos : m ; bottle : r h r h ; SEPARATE destroy bottle	thermos : m ;
flask : y ; canister : y g g c ; flagon : b h h b ; SEPARATE destroy flagon	flask : y ; canister : y g g c ;
jar : y r r d d ; decanter : g b b y ; SEPARATE destroy decanter	jar : y r r d d ;
glass : g g ; urn : a m ; SEPARATE destroy glass	urn : a m ;
jug : e h ; flagon : o ; bottle : a c a ; beaker : e ; SEPARATE destroy jug	flagon : o ; bottle : a c a ; beaker : e ;
mug : c c d g ; cup : y y m ; SEPARATE destroy mug	cup : y y m ;
beaker : d ; flask : d o e e d ; SEPARATE destroy flask	beaker : d ;
vessel : b b ; pitcher : m e v ; SEPARATE destroy vessel	pitcher : m e v ;
pitcher : e ; beaker : b d b f ; SEPARATE destroy pitcher	beaker : b d b f ;
vessel : d d h v ; burette : o p p ; SEPARATE destroy burette	vessel : d d h v ;
vessel : m f f ; beaker : d d ; flagon : v r ; SEPARATE destroy vessel	beaker : d d ; flagon : v r ;
vessel : v o o ; vessel : h b g b g ; SEPARATE destroy last vessel	vessel : v o o ;
flagon : y y ; cup : d r ; bottle : a a o p ; SEPARATE destroy cup	flagon : y y ; bottle : a a o p ;
jug : g ; beaker : p m p f f ; bottle : o e y ; SEPARATE destroy beaker	jug : g ; bottle : o e y ;
canister : r r e ; flask : h m h m y ; urn : d d ; SEPARATE destroy canister	flask : h m h m y ; urn : d d ;
flagon : e v v ; beaker : b e ; SEPARATE destroy beaker	flagon : e v v ;
vessel : d d f f ; beaker : g g ; flask : f ; SEPARATE destroy flask	vessel : d d f f ; beaker : g g ;
burette : e r e ; jar : d r g r d ; bottle : v b ; SEPARATE destroy jar	burette : e r e ; bottle : v b ;
thermos : c c v p ; decanter : h e h o o ; SEPARATE destroy thermos	decanter : h e h o o ;
thermos : r r ; pitcher : g b g f b ; SEPARATE destroy thermos	pitcher : g b g f b ;
canister : c b b o c o ; glass : a a ; vessel : d v v ; SEPARATE destroy vessel	canister : c b b o c o ; glass : a a ;
beaker : p d d p ; burette : p g m p ; SEPARATE destroy beaker	burette : p g m p ;
glass : v v ; jug : m d r ; cup : h o o ; SEPARATE destroy cup	glass : v v ; jug : m d r ;
canister : c ; beaker : p g g o p ; SEPARATE destroy beaker	canister : c ;
glass : e e f c f ; glass : e e p ; SEPARATE destroy last glass	glass : e e f c f ;
canister : f ; flagon : d h h d ; beaker : v ; burette : f ; SEPARATE destroy burette	canister : f ; flagon : d h h d ; beaker : v ;
canister : g g ; decanter : b b ; glass : e ; decanter : d d ; SEPARATE destroy glass	canister : g g ; decanter : b b ; decanter : d d ;
burette : p p y r r ; vessel : h ; SEPARATE destroy burette	vessel : h ;
jug : a o o ; jar : h d d h b ; SEPARATE destroy jug	jar : h d d h b ;
cup : y y v ; burette : y m m v v y ; flagon : f v v ; SEPARATE destroy cup	burette : y m m v v y ; flagon : f v v ;
jar : v f y ; flask : m m ; SEPARATE destroy jar	flask : m m ;
canister : f f ; canister : c c ; SEPARATE destroy first canister	canister : c c ;
jar : d d ; flagon : m f m ; SEPARATE destroy jar	flagon : m f m ;
flask : h o h ; flask : p c p ; glass : o ; flagon : b b ; SEPARATE destroy flagon	flask : h o h ; flask : p c p ; glass : o ;
decanter : v v ; thermos : v c v ; SEPARATE destroy thermos	decanter : v v ;
decanter : h h ; canister : r e ; cup : v v f f ; SEPARATE destroy canister	decanter : h h ; cup : v v f f ;
canister : y ; decanter : b ; SEPARATE destroy decanter	canister : y ;
jug : e ; cup : h ; decanter : p h a ; pitcher : h ; SEPARATE destroy jug	cup : h ; decanter : p h a ; pitcher : h ;
glass : m g g ; jar : r a r ; thermos : a d a d f ; SEPARATE destroy jar	glass : m g g ; thermos : a d a d f ;
flask : p p f ; pitcher : r ; vessel : d c d ; SEPARATE destroy vessel	flask : p p f ; pitcher : r ;
glass : b b e ; flask : b m r b ; SEPARATE destroy flask	glass : b b e ;
jar : r v r v m ; mug : g g a a y ; SEPARATE destroy mug	jar : r v r v m ;
jug : a h a ; pitcher : d p p ; mug : d y ; SEPARATE destroy jug	pitcher : d p p ; mug : d y ;
flask : d o b ; glass : m m r ; beaker : p v v p ; SEPARATE destroy flask	glass : m m r ; beaker : p v v p ;
vessel : m ; mug : m b e m ; thermos : m f ; SEPARATE destroy thermos	vessel : m ; mug : m b e m ;
urn : p r a r p ; mug : e e ; bottle : m d d p ; SEPARATE destroy urn	mug : e e ; bottle : m d d p ;
jug : f ; glass : f f ; flagon : y p ; glass : p v g ; SEPARATE destroy jug	glass : f f ; flagon : y p ; glass : p v g ;
burette : c ; vessel : o ; glass : m m ; SEPARATE destroy burette	vessel : o ; glass : m m ;
jar : o o ; vessel : e ; burette : o o ; jug : y m g g ; SEPARATE destroy jug	jar : o o ; vessel : e ; burette : o o ;
pitcher : m c y ; vessel : r ; thermos : m c a c a m ; SEPARATE destroy vessel	pitcher : m c y ; thermos : m c a c a m ;
flagon : r p ; cup : c c ; SEPARATE destroy flagon	cup : c c ;
jar : y y ; canister : c c ; mug : b y ; beaker : o m ; SEPARATE destroy beaker	jar : y y ; canister : c c ; mug : b y ;
cup : c c ; cup : g g v v ; flask : o g o g h ; SEPARATE destroy flask	cup : c c ; cup : g g v v ;
vessel : v y v y ; pitcher : c m v v ; SEPARATE destroy vessel	pitcher : c m v v ;
glass : c c v ; cup : a a d c ; SEPARATE destroy glass	cup : a a d c ;
flagon : m ; glass : g g ; flagon : h ; SEPARATE destroy last flagon	flagon : m ; glass : g g ;
flagon : f f v v ; flask : b f b f ; SEPARATE destroy flagon	flask : b f b f ;
decanter : a ; flask : g v v g ; vessel : d d ; SEPARATE destroy decanter	flask : g v v g ; vessel : d d ;
jar : m m h a ; glass : a a c c ; SEPARATE destroy jar	glass : a a c c ;
jug : p ; urn : b e r r ; SEPARATE destroy urn	jug : p ;
beaker : o v v y ; burette : o g g ; jar : f ; SEPARATE destroy jar	beaker : o v v y ; burette : o g g ;
flask : d ; urn : m v m f f ; SEPARATE destroy urn	flask : d ;
canister : o o ; flask : c a ; SEPARATE destroy canister	flask : c a ;
glass : m f m f o ; jar : d d c ; SEPARATE destroy glass	jar : d d c ;
vessel : r r ; bottle : v v f ; thermos : o v y ; SEPARATE destroy thermos	vessel : r r ; bottle : v v f ;
thermos : o o ; bottle : f ; SEPARATE destroy bottle	thermos : o o ;
burette : r p ; bottle : p p ; jar : v d m ; flask : h h ; SEPARATE destroy bottle	burette : r p ; jar : v d m ; flask : h h ;
jar : a ; flask : p v v p ; SEPARATE destroy jar	flask : p v v p ;
cup : h o ; flask : p ; SEPARATE destroy cup	flask : p ;
mug : c c ; vessel : h c m m h ; SEPARATE destroy vessel	mug : c c ;
vessel : a a v ; flagon : p h f p ; SEPARATE destroy flagon	vessel : a a v ;
beaker : p p g m ; bottle : r ; SEPARATE destroy beaker	bottle : r ;
decanter : f ; urn : g h ; pitcher : v y ; bottle : g f p g ; SEPARATE destroy pitcher	decanter : f ; urn : g h ; bottle : g f p g ;
thermos : f v ; thermos : m m ; SEPARATE destroy first thermos	thermos : m m ;
urn : c m c m ; burette : b v ; SEPARATE destroy burette	urn : c m c m ;
vessel : f b p ; beaker : f v f ; urn : d r r v ; SEPARATE destroy urn	vessel : f b p ; beaker : f v f ;
glass : v v b ; glass : r r a ; bottle : a a v g ; SEPARATE destroy bottle	glass : v v b ; glass : r r a ;
canister : d d r ; thermos : y y ; canister : g ; SEPARATE destroy thermos	canister : d d r ; canister : g ;
decanter : y d d y o ; glass : y y ; SEPARATE destroy decanter	glass : y y ;
pitcher : v m v c ; jar : a o a h ; flagon : y e e y ; SEPARATE destroy flagon	pitcher : v m v c ; jar : a o a h ;
urn : m d e ; thermos : f f ; SEPARATE destroy thermos	urn : m d e ;
decanter : e e ; flagon : c ; burette : v v g g ; flask : c ; SEPARATE destroy decanter	flagon : c ; burette : v v g g ; flask : c ;
vessel : o o a ; vessel : d ; SEPARATE destroy last vessel	vessel : o o a ;
decanter : o f p o ; flagon : o v v o ; SEPARATE destroy flagon	decanter : o f p o ;
burette : e e b ; cup : r f r b f b ; SEPARATE destroy cup	burette : e e b ;
flagon : e ; pitcher : g g ; jug : g o o ; SEPARATE destroy pitcher	flagon : e ; jug : g o o ;
beaker : c a e ; urn : b f f b ; SEPARATE destroy beaker	urn : b f f b ;
vessel : o h h c c o ; beaker : v p e v ; SEPARATE destroy vessel	beaker : v p e v ;
glass : y y ; urn : r g g y ; cup : a a ; SEPARATE destroy urn	glass : y y ; cup : a a ;
canister : b b d ; mug : r y ; flagon : f v g f v g ; SEPARATE destroy mug	canister : b b d ; flagon : f v g f v g ;
decanter : e e b ; urn : b a b m ; flagon : o m ; SEPARATE destroy urn	decanter : e e b ; flagon : o m ;
decanter : y g ; burette : h h ; bottle : v o v o ; SEPARATE destroy burette	decanter : y g ; bottle : v o v o ;
flagon : m v m v p ; cup : y y c ; cup : o p v ; SEPARATE destroy first cup	flagon : m v m v p ; cup : o p v ;
pitcher : o ; mug : f m f r m r ; SEPARATE destroy mug	pitcher : o ;
urn : e g g ; glass : h b p b h p ; bottle : b c b ; SEPARATE destroy bottle	urn : e g g ; glass : h b p b h p ;
jug : p y b p y ; decanter : g c c ; flagon : p a ; SEPARATE destroy flagon	jug : p y b p y ; decanter : g c c ;
thermos : d e e ; jar : m g ; burette : m m ; pitcher : c c ; SEPARATE destroy burette	thermos : d e e ; jar : m g ; pitcher : c c ;
vessel : c d e e ; canister : r r f ; flagon : m m ; SEPARATE destroy flagon	vessel : c d e e ; canister : r r f ;
bottle : p ; canister : f r p f p ; SEPARATE destroy canister	bottle : p ;
beaker : c c ; glass : c y c y h ; SEPARATE destroy beaker	glass : c y c y h ;
thermos : a ; flagon : g g p ; glass : a a ; mug : g ; SEPARATE destroy mug	thermos : a ; flagon : g g p ; glass : a a ;
urn : e e p p ; vessel : c g c ; SEPARATE destroy vessel	urn : e e p p ;
mug : h ; jar : e ; urn : b ; SEPARATE destroy mug	jar : e ; urn : b ;
flagon : c ; cup : c c ; jug : d d m p ; thermos : h o ; SEPARATE destroy jug	flagon : c ; cup : c c ; thermos : h o ;
vessel : o o ; pitcher : r d d r ; decanter : m m b ; SEPARATE destroy vessel	pitcher : r d d r ; decanter : m m b ;
mug : o o ; flagon : c c ; glass : g c y g y ; SEPARATE destroy glass	mug : o o ; flagon : c c ;
decanter : g v ; beaker : g b h ; burette : f f a a ; SEPARATE destroy beaker	decanter : g v ; burette : f f a a ;
flask : v b b ; vessel : y y a r r ; SEPARATE destroy flask	vessel : y y a r r ;
burette : v v ; glass : e r r c e ; cup : p p ; SEPARATE destroy cup	burette : v v ; glass : e r r c e ;
pitcher : h h d e ; vessel : m ; SEPARATE destroy pitcher	vessel : m ;
urn : v ; decanter : c d r ; jar : a o a ; SEPARATE destroy jar	urn : v ; decanter : c d r ;
canister : o ; flask : p r r ; vessel : c d c d g g ; SEPARATE destroy vessel	canister : o ; flask : p r r ;
bottle : g ; vessel : c m c ; bottle : r y e r y ; SEPARATE destroy last bottle	bottle : g ; vessel : c m c ;
jar : o o ; bottle : f o v v f ; SEPARATE destroy bottle	jar : o o ;
mug : h g h ; cup : c b m b ; SEPARATE destroy cup	mug : h g h ;
burette : a o o a ; vessel : b ; burette : m y b m y ; SEPARATE destroy first burette	vessel : b ; burette : m y b m y ;
flagon : m m ; decanter : m ; SEPARATE destroy flagon	decanter : m ;
bottle : p r ; burette : v c c d d ; flask : v o a ; SEPARATE destroy burette	bottle : p r ; flask : v o a ;
burette : d c c d ; vessel : b b p ; flagon : m m v ; SEPARATE destroy flagon	burette : d c c d ; vessel : b b p ;
flagon : v a a v ; pitcher : y y h h ; canister : h ; SEPARATE destroy canister	flagon : v a a v ; pitcher : y y h h ;
cup : h d g h g ; jug : y y b ; vessel : b r b v ; SEPARATE destroy cup	jug : y y b ; vessel : b r b v ;
flagon : m m ; jug : g b d b ; jar : o p e ; SEPARATE destroy jar	flagon : m m ; jug : g b d b ;
bottle : a b b a ; cup : c e m e ; SEPARATE destroy bottle	cup : c e m e ;
bottle : o v o ; mug : g g ; burette : a ; SEPARATE destroy mug	bottle : o v o ; burette : a ;
vessel : b y c c ; beaker : o ; SEPARATE destroy beaker	vessel : b y c c ;
cup : v v m ; cup : f ; thermos : e e ; SEPARATE destroy second cup	cup : v v m ; thermos : e e ;
flask : y ; beaker : o o f ; jug : y y ; flask : o ; SEPARATE destroy beaker	flask : y ; jug : y y ; flask : o ;
cup : v v d d ; cup : o a o ; SEPARATE destroy first cup	cup : o a o ;
cup : y v ; jug : c ; canister : p p ; SEPARATE destroy cup	jug : c ; canister : p p ;
bottle : a m ; bottle : e ; cup : h h b d ; SEPARATE destroy first bottle	bottle : e ; cup : h h b d ;
urn : y g g ; mug : r b b r m ; cup : y y ; SEPARATE destroy mug	urn : y g g ; cup : y y ;
bottle : o b ; mug : v v ; SEPARATE destroy mug	bottle : o b ;
glass : v v f f ; pitcher : h c o c ; mug : h e e f ; SEPARATE destroy mug	glass : v v f f ; pitcher : h c o c ;
pitcher : c c ; mug : m o o ; SEPARATE destroy mug	pitcher : c c ;
beaker : r a r a p ; flagon : a a ; canister : h e e ; SEPARATE destroy canister	beaker : r a r a p ; flagon : a a ;
urn : r r ; pitcher : o ; SEPARATE destroy pitcher	urn : r r ;
jar : h h ; bottle : p ; urn : y ; SEPARATE destroy bottle	jar : h h ; urn : y ;
jug : f f ; pitcher : c c ; jar : h h r r ; SEPARATE destroy jar	jug : f f ; pitcher : c c ;
beaker : e v e ; canister : p p g ; SEPARATE destroy beaker	canister : p p g ;
flagon : c y m ; burette : c ; SEPARATE destroy burette	flagon : c y m ;
jug : p ; thermos : v h ; canister : e e c d ; SEPARATE destroy thermos	jug : p ; canister : e e c d ;
cup : r f b b f ; cup : p g p ; SEPARATE destroy first cup	cup : p g p ;
cup : v ; jar : o o ; flagon : d m ; SEPARATE destroy cup	jar : o o ; flagon : d m ;
beaker : p d o ; beaker : b b r v ; SEPARATE destroy last beaker	beaker : p d o ;
beaker : b d m ; mug : r a r c a ; SEPARATE destroy mug	beaker : b d m ;
urn : p e p ; glass : y y ; urn : r ; pitcher : y ; SEPARATE destroy last urn	urn : p e p ; glass : y y ; pitcher : y ;
urn : g g ; mug : o c v ; SEPARATE destroy mug	urn : g g ;
flask : r y ; flask : d d ; SEPARATE destroy first flask	flask : d d ;
glass : g d g ; jug : p ; SEPARATE destroy jug	glass : g d g ;
mug : f y v v y f ; jug : v p f p ; jar : d ; SEPARATE destroy mug	jug : v p f p ; jar : d ;
jar : c ; thermos : v ; SEPARATE destroy jar	thermos : v ;
flagon : e e ; cup : e ; urn : f ; burette : c f o c ; SEPARATE destroy cup	flagon : e e ; urn : f ; burette : c f o c ;
flask : f p g p g f ; urn : v e o v ; urn : e e ; SEPARATE destroy flask	urn : v e o v ; urn : e e ;
jar : m m ; burette : m r r m o ; vessel : e o ; SEPARATE destroy burette	jar : m m ; vessel : e o ;
beaker : m m o ; decanter : b v h ; SEPARATE destroy decanter	beaker : m m o ;
burette : r d ; thermos : p r r g g p ; SEPARATE destroy burette	thermos : p r r g g p ;
thermos : y p p ; bottle : c o ; glass : y y ; SEPARATE destroy bottle	thermos : y p p ; glass : y y ;
flagon : p d f ; mug : g g ; mug : b d d e ; SEPARATE destroy flagon	mug : g g ; mug : b d d e ;
bottle : f f ; jug : h h ; SEPARATE destroy jug	bottle : f f ;
bottle : f y y m m ; jug : d c c d ; beaker : e y a ; SEPARATE destroy jug	bottle : f y y m m ; beaker : e y a ;
canister : d g g ; burette : h o o e h ; cup : h b ; SEPARATE destroy burette	canister : d g g ; cup : h b ;
urn : b ; urn : b c p ; SEPARATE destroy last urn	urn : b ;
bottle : r b b r ; jar : a ; decanter : g p d p g ; SEPARATE destroy bottle	jar : a ; decanter : g p d p g ;
pitcher : a g a ; jar : a b f b f ; pitcher : g m m ; SEPARATE destroy jar	pitcher : a g a ; pitcher : g m m ;
pitcher : b ; cup : r r o o ; SEPARATE destroy pitcher	cup : r r o o ;
burette : f e f e y ; burette : e ; mug : r r ; SEPARATE destroy first burette	burette : e ; mug : r r ;
bottle : h ; thermos : g h b g h ; burette : r b e ; SEPARATE destroy bottle	thermos : g h b g h ; burette : r b e ;
mug : d v v d ; mug : a r d d a ; SEPARATE destroy last mug	mug : d v v d ;
burette : p d a ; thermos : b c b c ; cup : y h f h ; SEPARATE destroy cup	burette : p d a ; thermos : b c b c ;
flagon : p g p b ; thermos : g ; SEPARATE destroy thermos	flagon : p g p b ;
jug : r h h e ; vessel : f p ; burette : y ; SEPARATE destroy jug	vessel : f p ; burette : y ;
flagon : p ; cup : p ; glass : a a ; SEPARATE destroy flagon	cup : p ; glass : a a ;
urn : h h ; urn : d d ; jug : f e ; SEPARATE destroy last urn	urn : h h ; jug : f e ;
bottle : v e c c ; jug : c c e ; canister : h p b b p ; SEPARATE destroy bottle	jug : c c e ; canister : h p b b p ;
decanter : h a b a h b ; decanter : b b c e ; SEPARATE destroy first decanter	decanter : b b c e ;
burette : m m f ; flask : v v g g a ; SEPARATE destroy flask	burette : m m f ;
jar : v v f f ; canister : f o m m f ; SEPARATE destroy jar	canister : f o m m f ;
beaker : h ; beaker : b h b ; bottle : g h a a h ; SEPARATE destroy last beaker	beaker : h ; bottle : g h a a h ;
glass : b p ; burette : y y ; SEPARATE destroy burette	glass : b p ;
flask : e ; beaker : g ; SEPARATE destroy flask	beaker : g ;
vessel : v d y d ; jar : g c r r c ; urn : o h ; SEPARATE destroy vessel	jar : g c r r c ; urn : o h ;
flagon : y ; burette : g g m f f ; urn : r o r ; SEPARATE destroy burette	flagon : y ; urn : r o r ;
thermos : p o ; flagon : c c ; SEPARATE destroy flagon	thermos : p o ;
pitcher : f f g g ; urn : g ; SEPARATE destroy urn	pitcher : f f g g ;
flask : a a p ; urn : p a c p ; canister : m y e e ; SEPARATE destroy flask	urn : p a c p ; canister : m y e e ;
mug : h v g ; jar : a y y ; glass : m m ; SEPARATE destroy mug	jar : a y y ; glass : m m ;
bottle : m d m r r ; decanter : m ; SEPARATE destroy decanter	bottle : m d m r r ;
thermos : o o ; pitcher : r ; decanter : h h ; SEPARATE destroy thermos	pitcher : r ; decanter : h h ;
beaker : m ; glass : y m v ; flask : p g ; SEPARATE destroy flask	beaker : m ; glass : y m v ;
decanter : v e v ; decanter : p y p ; SEPARATE destroy last decanter	decanter : v e v ;
thermos : b o o ; jug : h ; SEPARATE destroy thermos	jug : h ;
canister : v v ; burette : f p f y y ; cup : r y y o ; SEPARATE destroy canister	burette : f p f y y ; cup : r y y o ;
jug : h ; glass : a a p c c ; SEPARATE destroy jug	glass : a a p c c ;
vessel : g h g h ; flask : f c ; SEPARATE destroy vessel	flask : f c ;
cup : h p h ; decanter : r r ; SEPARATE destroy cup	decanter : r r ;
cup : r r ; urn : y ; flagon : v ; bottle : a a d p ; SEPARATE destroy urn	cup : r r ; flagon : v ; bottle : a a d p ;
pitcher : r a r g g a ; burette : v ; burette : a a ; SEPARATE destroy pitcher	burette : v ; burette : a a ;
flagon : e p ; burette : p g g ; SEPARATE destroy burette	flagon : e p ;
canister : r h r ; vessel : p p ; flagon : h h o ; SEPARATE destroy vessel	canister : r h r ; flagon : h h o ;
bottle : h ; pitcher : p ; jug : b b ; cup : e f ; SEPARATE destroy cup	bottle : h ; pitcher : p ; jug : b b ;
urn : a ; burette : v b b m v m ; SEPARATE destroy burette	urn : a ;
pitcher : y e y e ; pitcher : o f o ; SEPARATE destroy last pitcher	pitcher : y e y e ;
pitcher : h y b ; glass : b b ; SEPARATE destroy glass	pitcher : h y b ;
thermos : h h ; flagon : y y ; jug : c d d ; flask : d ; SEPARATE destroy flagon	thermos : h h ; jug : c d d ; flask : d ;
flask : h g g h ; bottle : a p ; SEPARATE destroy flask	bottle : a p ;
beaker : h ; canister : p f h ; cup : y y d d b ; SEPARATE destroy canister	beaker : h ; cup : y y d d b ;
jar : p p ; urn : y g r r y ; SEPARATE destroy urn	jar : p p ;
burette : a ; jar : r r ; glass : d o ; jar : p o o ; SEPARATE destroy burette	jar : r r ; glass : d o ; jar : p o o ;
glass : h g h f ; urn : f f ; flask : g g ; SEPARATE destroy flask	glass : h g h f ; urn : f f ;
flagon : d d ; mug : b m m ; SEPARATE destroy mug	flagon : d d ;
thermos : h v e ; vessel : h h ; vessel : a a ; SEPARATE destroy first vessel	thermos : h v e ; vessel : a a ;
flask : b b ; decanter : v v ; jar : a ; SEPARATE destroy decanter	flask : b b ; jar : a ;
burette : d d f ; flask : h b h v ; SEPARATE destroy flask	burette : d d f ;
pitcher : r e p p ; mug : g h h g o o ; SEPARATE destroy mug	pitcher : r e p p ;
mug : p ; flagon : g g ; flask : c a a e ; SEPARATE destroy flask	mug : p ; flagon : g g ;
jar : y d y ; jar : f f ; SEPARATE destroy first jar	jar : f f ;
flask : f v v f ; burette : f a r f ; burette : g g ; SEPARATE destroy second burette	flask : f v v f ; burette : f a r f ;
decanter : c o r ; burette : h h ; canister : m y v y v ; SEPARATE destroy decanter	burette : h h ; canister : m y v y v ;
flagon : a a m ; glass : g d d g ; burette : b ; decanter : b ; SEPARATE destroy burette	flagon : a a m ; glass : g d d g ; decanter : b ;
burette : f h r f h ; flask : a h a ; SEPARATE destroy flask	burette : f h r f h ;
canister : y y ; pitcher : d d m ; vessel : g v o o v g ; SEPARATE destroy vessel	canister : y y ; pitcher : d d m ;
jug : v h r r h ; flagon : m ; SEPARATE destroy flagon	jug : v h r r h ;
burette : d v d ; flask : c h ; SEPARATE destroy flask	burette : d v d ;
pitcher : y y ; flask : v y y r ; SEPARATE destroy pitcher	flask : v y y r ;
urn : g ; canister : y f o ; SEPARATE destroy canister	urn : g ;
thermos : e e b ; bottle : o a o b a b ; SEPARATE destroy bottle	thermos : e e b ;
canister : f f ; cup : c a o a c o ; SEPARATE destroy canister	cup : c a o a c o ;
mug : y o y ; decanter : f r r ; SEPARATE destroy mug	decanter : f r r ;
glass : g ; beaker : f f m ; SEPARATE destroy glass	beaker : f f m ;
beaker : a m a r r ; beaker : f ; SEPARATE destroy first beaker	beaker : f ;
pitcher : c f f ; burette : d ; pitcher : g g ; SEPARATE destroy first pitcher	burette : d ; pitcher : g g ;
beaker : o a m m ; cup : v v ; SEPARATE destroy cup	beaker : o a m m ;
jar : b f ; pitcher : r a a ; glass : r r ; bottle : y ; SEPARATE destroy glass	jar : b f ; pitcher : r a a ; bottle : y ;
cup : a v a ; pitcher : o f ; SEPARATE destroy pitcher	cup : a v a ;
decanter : r r ; glass : p h p h ; mug : r ; SEPARATE destroy decanter	glass : p h p h ; mug : r ;
flask : m m ; urn : a y a ; SEPARATE destroy urn	flask : m m ;
bottle : e b r r ; mug : d f ; flagon : f a o ; SEPARATE destroy flagon	bottle : e b r r ; mug : d f ;
burette : m ; pitcher : d m ; flask : m m ; mug : c c ; SEPARATE destroy flask	burette : m ; pitcher : d m ; mug : c c ;
cup : a a r b ; jar : r b r p p ; decanter : e e ; SEPARATE destroy jar	cup : a a r b ; decanter : e e ;
mug : o ; bottle : f f ; flagon : f ; SEPARATE destroy bottle	mug : o ; flagon : f ;
jar : b y b ; cup : c b b c ; thermos : v v c ; SEPARATE destroy thermos	jar : b y b ; cup : c b b c ;
bottle : a g a c ; jug : v f b b ; beaker : v ; SEPARATE destroy bottle	jug : v f b b ; beaker : v ;
glass : r ; bottle : a ; mug : b b e p ; pitcher : e ; SEPARATE destroy bottle	glass : r ; mug : b b e p ; pitcher : e ;
jar : g r r ; thermos : a a ; jar : r ; SEPARATE destroy second jar	jar : g r r ; thermos : a a ;
pitcher : r v r ; cup : a p ; SEPARATE destroy cup	pitcher : r v r ;
burette : r r ; urn : f f ; flask : o b o f f ; SEPARATE destroy urn	burette : r r ; flask : o b o f f ;
cup : p c c p f ; burette : f f ; SEPARATE destroy cup	burette : f f ;
beaker : c ; vessel : e f ; jar : v v ; SEPARATE destroy jar	beaker : c ; vessel : e f ;
burette : d d v ; canister : e p c c p ; glass : r r ; SEPARATE destroy canister	burette : d d v ; glass : r r ;
flagon : a y ; bottle : a ; canister : r r e a e a ; flask : e ; SEPARATE destroy flask	flagon : a y ; bottle : a ; canister : r r e a e a ;
cup : m f f m o ; flask : m m h p h p ; SEPARATE destroy flask	cup : m f f m o ;
burette : h h ; decanter : c ; SEPARATE destroy burette	decanter : c ;
burette : r r b ; urn : h ; flask : r g ; SEPARATE destroy burette	urn : h ; flask : r g ;
canister : a f ; glass : c d c ; SEPARATE destroy glass	canister : a f ;
jug : m ; vessel : f f ; decanter : p r p r b ; glass : d d ; SEPARATE destroy glass	jug : m ; vessel : f f ; decanter : p r p r b ;
vessel : h ; urn : p e p ; SEPARATE destroy vessel	urn : p e p ;
flagon : g ; glass : p r p ; jar : r a ; SEPARATE destroy glass	flagon : g ; jar : r a ;
beaker : g g a p ; canister : d d v v ; SEPARATE destroy canister	beaker : g g a p ;
beaker : m p m ; glass : p ; jar : y y e ; SEPARATE destroy beaker	glass : p ; jar : y y e ;
decanter : d ; cup : v v ; bottle : f v v ; SEPARATE destroy cup	decanter : d ; bottle : f v v ;
burette : o y y ; burette : g d e ; SEPARATE destroy last burette	burette : o y y ;
jug : v ; mug : c c ; bottle : a m ; SEPARATE destroy mug	jug : v ; bottle : a m ;
jar : g g ; canister : a e r r ; flask : r a r a ; SEPARATE destroy jar	canister : a e r r ; flask : r a r a ;
cup : p p o o v ; canister : v m f ; glass : h h ; SEPARATE destroy glass	cup : p p o o v ; canister : v m f ;
thermos : a e e a ; canister : e a e a ; SEPARATE destroy canister	thermos : a e e a ;
urn : c a c a ; cup : y ; SEPARATE destroy cup	urn : c a c a ;
thermos : e e ; urn : b o b ; SEPARATE destroy urn	thermos : e e ;
thermos : g ; jar : g g e a ; SEPARATE destroy thermos	jar : g g e a ;
flagon : c c ; vessel : c d d ; SEPARATE destroy flagon	vessel : c d d ;
beaker : p f p h ; mug : g g r ; glass : r c ; SEPARATE destroy beaker	mug : g g r ; glass : r c ;
bottle : f o g o ; canister : p p f f ; jug : d v ; SEPARATE destroy canister	bottle : f o g o ; jug : d v ;
decanter : h v ; flask : g m g b m ; cup : c c f ; SEPARATE destroy decanter	flask : g m g b m ; cup : c c f ;
thermos : d a d ; cup : a f ; SEPARATE destroy cup	thermos : d a d ;
flagon : d d ; bottle : v h y v ; jar : c y e ; SEPARATE destroy bottle	flagon : d d ; jar : c y e ;
urn : g ; pitcher : r r ; glass : a a ; burette : v g g v ; SEPARATE destroy burette	urn : g ; pitcher : r r ; glass : a a ;
canister : m m g ; burette : y y ; SEPARATE destroy canister	burette : y y ;
urn : f f ; pitcher : e h e ; SEPARATE destroy urn	pitcher : e h e ;
glass : b ; burette : h ; mug : v v a ; SEPARATE destroy glass	burette : h ; mug : v v a ;
pitcher : f f e e ; beaker : r c y r y ; SEPARATE destroy beaker	pitcher : f f e e ;
jug : y ; vessel : h c h c ; SEPARATE destroy jug	vessel : h c h c ;
bottle : c d v ; flask : e y y ; SEPARATE destroy flask	bottle : c d v ;
thermos : d p d ; pitcher : d p ; SEPARATE destroy thermos	pitcher : d p ;
decanter : e y e ; mug : v c ; jug : c v v ; SEPARATE destroy decanter	mug : v c ; jug : c v v ;
mug : g d a ; vessel : o v o v ; glass : g p m g ; SEPARATE destroy mug	vessel : o v o v ; glass : g p m g ;
burette : f r r m ; flagon : p ; flagon : a h r a ; SEPARATE destroy second flagon	burette : f r r m ; flagon : p ;
bottle : a c ; glass : a c a r r ; SEPARATE destroy glass	bottle : a c ;
mug : e e ; flask : o r ; pitcher : g ; bottle : e f e ; SEPARATE destroy mug	flask : o r ; pitcher : g ; bottle : e f e ;
glass : o o ; mug : c g g ; SEPARATE destroy mug	glass : o o ;
mug : p p ; bottle : m ; SEPARATE destroy bottle	mug : p p ;
canister : m r r e ; pitcher : y r y r ; pitcher : b h e h ; SEPARATE destroy canister	pitcher : y r y r ; pitcher : b h e h ;
pitcher : a b y ; jug : o b ; cup : b b ; SEPARATE destroy cup	pitcher : a b y ; jug : o b ;
pitcher : y y d ; thermos : v v ; bottle : e h m ; SEPARATE destroy pitcher	thermos : v v ; bottle : e h m ;
canister : v o v ; glass : g e e g ; burette : b b ; SEPARATE destroy glass	canister : v o v ; burette : b b ;
glass : g f ; cup : b b e e p ; SEPARATE destroy cup	glass : g f ;
beaker : p p y ; decanter : p d ; SEPARATE destroy beaker	decanter : p d ;
urn : g c r c g r ; beaker : h o o f h ; SEPARATE destroy beaker	urn : g c r c g r ;
thermos : a r r ; vessel : o g g v ; SEPARATE destroy vessel	thermos : a r r ;
jug : e d g d ; mug : a a c ; decanter : g v ; SEPARATE destroy decanter	jug : e d g d ; mug : a a c ;
burette : a y a y ; decanter : f f o o d d ; jar : v v ; SEPARATE destroy jar	burette : a y a y ; decanter : f f o o d d ;
flagon : m ; glass : o ; SEPARATE destroy glass	flagon : m ;
glass : v ; mug : e p e p h ; mug : c c m p p ; SEPARATE destroy glass	mug : e p e p h ; mug : c c m p p ;
flagon : c y v c ; pitcher : o h o ; glass : b b ; SEPARATE destroy flagon	pitcher : o h o ; glass : b b ;
thermos : d d o ; mug : p p a ; bottle : o p m p o ; SEPARATE destroy mug	thermos : d d o ; bottle : o p m p o ;
cup : o h d o h d ; vessel : d ; SEPARATE destroy vessel	cup : o h d o h d ;
decanter : e e ; jar : p b b ; jug : a b b ; SEPARATE destroy jug	decanter : e e ; jar : p b b ;
mug : g g ; burette : r r ; cup : c f f c r r ; SEPARATE destroy cup	mug : g g ; burette : r r ;
mug : c v r r c v ; cup : y ; mug : m m ; SEPARATE destroy last mug	mug : c v r r c v ; cup : y ;
bottle : y y ; bottle : a a ; flask : g c g m ; SEPARATE destroy last bottle	bottle : y y ; flask : g c g m ;
glass : o ; pitcher : f h h ; SEPARATE destroy glass	pitcher : f h h ;
glass : b b ; jug : c d f f ; vessel : b b ; SEPARATE destroy glass	jug : c d f f ; vessel : b b ;
decanter : o c ; bottle : r r ; bottle : c ; SEPARATE destroy first bottle	decanter : o c ; bottle : c ;
flagon : o m m ; flask : m ; SEPARATE destroy flagon	flask : m ;
jug : r ; glass : v v ; SEPARATE destroy jug	glass : v v ;
beaker : y ; cup : f f ; jug : r a e e ; SEPARATE destroy jug	beaker : y ; cup : f f ;
urn : h ; jar : b b ; jug : h h o ; SEPARATE destroy urn	jar : b b ; jug : h h o ;
urn : y ; jar : a c o ; bottle : b d e d ; SEPARATE destroy bottle	urn : y ; jar : a c o ;
vessel : a ; thermos : r r ; canister : r a ; SEPARATE destroy canister	vessel : a ; thermos : r r ;
jar : h ; bottle : m ; glass : g y ; glass : h ; SEPARATE destroy first glass	jar : h ; bottle : m ; glass : h ;
jug : c c p v p ; canister : a ; burette : r r ; SEPARATE destroy jug	canister : a ; burette : r r ;
glass : p p ; jug : e ; glass : r ; bottle : c b o b ; SEPARATE destroy bottle	glass : p p ; jug : e ; glass : r ;
bottle : b b ; flagon : o r e ; thermos : c c ; SEPARATE destroy thermos	bottle : b b ; flagon : o r e ;
flagon : y y v v m m ; canister : d d ; burette : m y m y ; SEPARATE destroy canister	flagon : y y v v m m ; burette : m y m y ;
canister : o ; jar : a c c ; cup : c d c e d ; SEPARATE destroy canister	jar : a c c ; cup : c d c e d ;
decanter : f a a g f ; canister : f f ; thermos : p p e r ; SEPARATE destroy decanter	canister : f f ; thermos : p p e r ;
flagon : y d d y o ; bottle : h a h ; SEPARATE destroy flagon	bottle : h a h ;
cup : r a r ; burette : f r a a ; pitcher : g e g e ; SEPARATE destroy cup	burette : f r a a ; pitcher : g e g e ;
glass : m m ; mug : y o ; flask : a r c c ; SEPARATE destroy glass	mug : y o ; flask : a r c c ;
beaker : y a a ; bottle : g m g ; SEPARATE destroy beaker	bottle : g m g ;
beaker : c g g ; beaker : m o m ; pitcher : h h y b y ; SEPARATE destroy second beaker	beaker : c g g ; pitcher : h h y b y ;
flagon : a h a v ; urn : v ; SEPARATE destroy flagon	urn : v ;
urn : c ; canister : b b d d ; SEPARATE destroy urn	canister : b b d d ;
canister : d d ; flagon : r d ; canister : y a y a ; SEPARATE destroy second canister	canister : d d ; flagon : r d ;
canister : d d ; burette : m h o ; decanter : v v ; SEPARATE destroy burette	canister : d d ; decanter : v v ;
vessel : m b b p p ; burette : d e f f ; SEPARATE destroy vessel	burette : d e f f ;
thermos : g m m ; cup : f f ; urn : e m y e y ; SEPARATE destroy thermos	cup : f f ; urn : e m y e y ;
beaker : o p o p ; decanter : h h ; beaker : h c c y h ; SEPARATE destroy first beaker	decanter : h h ; beaker : h c c y h ;
flagon : r a a ; mug : b b ; SEPARATE destroy mug	flagon : r a a ;
flagon : p p e ; pitcher : f g f d d ; jug : h y y ; SEPARATE destroy flagon	pitcher : f g f d d ; jug : h y y ;
thermos : d ; pitcher : r g v g ; SEPARATE destroy thermos	pitcher : r g v g ;
mug : p d h p d ; flagon : c ; pitcher : y y c c m ; SEPARATE destroy pitcher	mug : p d h p d ; flagon : c ;
urn : a ; vessel : f g r ; SEPARATE destroy vessel	urn : a ;
canister : c b y ; jug : a ; SEPARATE destroy jug	canister : c b y ;
bottle : r e c ; beaker : g ; SEPARATE destroy beaker	bottle : r e c ;
flagon : b b ; pitcher : f p ; SEPARATE destroy flagon	pitcher : f p ;
burette : b p p b g g ; beaker : b b g ; SEPARATE destroy burette	beaker : b b g ;
bottle : y y m m ; vessel : f ; mug : v ; SEPARATE destroy vessel	bottle : y y m m ; mug : v ;
beaker : o c c ; mug : a a c b ; SEPARATE destroy mug	beaker : o c c ;
flask : g h y ; canister : g ; flask : h h ; SEPARATE destroy first flask	canister : g ; flask : h h ;
canister : v v ; glass : v o o a ; mug : c ; SEPARATE destroy glass	canister : v v ; mug : c ;
vessel : a a ; urn : r ; flask : g g ; SEPARATE destroy flask	vessel : a a ; urn : r ;
canister : y ; burette : y r b r b ; SEPARATE destroy canister	burette : y r b r b ;
burette : d y y ; bottle : a a o ; SEPARATE destroy burette	bottle : a a o ;
glass : c a e c e ; canister : v v m g m ; SEPARATE destroy glass	canister : v v m g m ;
bottle : y ; decanter : f m f p ; flask : y y ; jar : e e ; SEPARATE destroy bottle	decanter : f m f p ; flask : y y ; jar : e e ;
jug : c ; pitcher : g g y y e e ; thermos : v e r ; SEPARATE destroy thermos	jug : c ; pitcher : g g y y e e ;
decanter : a a ; bottle : r r o o c c ; SEPARATE destroy bottle	decanter : a a ;
decanter : h ; bottle : a a o f f ; SEPARATE destroy decanter	bottle : a a o f f ;
jar : h h ; jug : v v f f ; cup : c g c g a ; SEPARATE destroy cup	jar : h h ; jug : v v f f ;
thermos : d g b b g ; urn : p e d ; mug : v v ; SEPARATE destroy urn	thermos : d g b b g ; mug : v v ;
thermos : o o ; bottle : v r a ; SEPARATE destroy bottle	thermos : o o ;
pitcher : m p ; canister : r r ; decanter : v g g v o o ; SEPARATE destroy pitcher	canister : r r ; decanter : v g g v o o ;
canister : o ; canister : p p d ; canister : v v ; SEPARATE destroy first canister	canister : p p d ; canister : v v ;
bottle : p ; urn : b ; beaker : h p p ; mug : y a y c c ; SEPARATE destroy bottle	urn : b ; beaker : h p p ; mug : y a y c c ;
flagon : a a m ; thermos : c c ; vessel : r a d ; SEPARATE destroy vessel	flagon : a a m ; thermos : c c ;
vessel : p p ; canister : b ; glass : y b ; urn : v o v ; SEPARATE destroy glass	vessel : p p ; canister : b ; urn : v o v ;
cup : m o o ; jar : o ; burette : p ; jug : o ; SEPARATE destroy jug	cup : m o o ; jar : o ; burette : p ;
flask : r r ; jar : v m v d ; decanter : c e y y e ; SEPARATE destroy jar	flask : r r ; decanter : c e y y e ;
mug : f b h h f ; decanter : v ; SEPARATE destroy decanter	mug : f b h h f ;
flask : f e ; flagon : d h o ; SEPARATE destroy flask	flagon : d h o ;
vessel : o p p o ; jar : p ; urn : e f e f ; SEPARATE destroy jar	vessel : o p p o ; urn : e f e f ;
flagon : g h g h r ; flagon : a a ; beaker : a c a ; SEPARATE destroy first flagon	flagon : a a ; beaker : a c a ;
decanter : e g g e ; cup : a a ; beaker : v r r v ; SEPARATE destroy cup	decanter : e g g e ; beaker : v r r v ;
burette : a p c p a ; cup : f v d v d ; SEPARATE destroy cup	burette : a p c p a ;
pitcher : y y b ; pitcher : c c r ; pitcher : d d ; SEPARATE destroy last pitcher	pitcher : y y b ; pitcher : c c r ;
glass : h o o ; decanter : p y y ; flagon : e m m ; SEPARATE destroy decanter	glass : h o o ; flagon : e m m ;
mug : c ; glass : b ; canister : m m ; urn : f p f o o ; SEPARATE destroy urn	mug : c ; glass : b ; canister : m m ;
flask : e ; canister : g h m ; flagon : d e ; SEPARATE destroy flagon	flask : e ; canister : g h m ;
bottle : h b ; pitcher : c d d v ; SEPARATE destroy bottle	pitcher : c d d v ;
flagon : r v y r y ; jar : e r e ; beaker : y ; SEPARATE destroy flagon	jar : e r e ; beaker : y ;
bottle : g ; bottle : o o ; pitcher : e e d f f d ; SEPARATE destroy last bottle	bottle : g ; pitcher : e e d f f d ;
thermos : r f c f r ; decanter : e m e m a ; SEPARATE destroy thermos	decanter : e m e m a ;
vessel : g y ; vessel : r r ; SEPARATE destroy first vessel	vessel : r r ;
beaker : f d d ; glass : a a ; SEPARATE destroy glass	beaker : f d d ;
mug : c c ; canister : e ; beaker : v b ; canister : e y e p ; SEPARATE destroy beaker	mug : c c ; canister : e ; canister : e y e p ;
beaker : v v ; bottle : c c g m m g ; SEPARATE destroy beaker	bottle : c c g m m g ;
cup : p a p o ; cup : p p c b ; SEPARATE destroy last cup	cup : p a p o ;
flask : r r ; decanter : g r g ; SEPARATE destroy flask	decanter : g r g ;
bottle : d c d ; jug : d d m p p ; SEPARATE destroy jug	bottle : d c d ;
thermos : h h ; glass : v e v p ; SEPARATE destroy glass	thermos : h h ;
cup : g g ; glass : y ; canister : e r ; SEPARATE destroy cup	glass : y ; canister : e r ;
vessel : h ; bottle : e e ; SEPARATE destroy bottle	vessel : h ;
glass : p p e ; vessel : o f f m o m ; SEPARATE destroy glass	vessel : o f f m o m ;
beaker : f ; jar : v r r ; burette : r r ; SEPARATE destroy jar	beaker : f ; burette : r r ;
thermos : p f g ; vessel : g ; SEPARATE destroy vessel	thermos : p f g ;
canister : b y y b ; flagon : d d p g ; SEPARATE destroy flagon	canister : b y y b ;
pitcher : e m m ; decanter : v e g ; SEPARATE destroy pitcher	decanter : v e g ;
urn : p y y ; flagon : o e v o e ; canister : y e e ; SEPARATE destroy flagon	urn : p y y ; canister : y e e ;
canister : f a r r a ; cup : m y ; jar : p m ; SEPARATE destroy jar	canister : f a r r a ; cup : m y ;
thermos : b ; jug : o g v o ; beaker : d d ; urn : r r ; SEPARATE destroy jug	thermos : b ; beaker : d d ; urn : r r ;
glass : o o g ; flask : b b r ; pitcher : c h h ; SEPARATE destroy flask	glass : o o g ; pitcher : c h h ;
jug : v a v ; flagon : g ; SEPARATE destroy flagon	jug : v a v ;
flagon : p e o o ; jar : a a ; SEPARATE destroy jar	flagon : p e o o ;
burette : d d o a ; flagon : f m ; SEPARATE destroy burette	flagon : f m ;
glass : d c c ; vessel : b e g b e ; SEPARATE destroy glass	vessel : b e g b e ;
burette : y a a ; glass : y y ; flagon : e a a f e ; SEPARATE destroy glass	burette : y a a ; flagon : e a a f e ;
flagon : v v e ; urn : o ; vessel : y b b ; SEPARATE destroy flagon	urn : o ; vessel : y b b ;
vessel : c b c ; flagon : v v e y ; SEPARATE destroy flagon	vessel : c b c ;
beaker : c c m ; thermos : r r b f b ; flagon : m e m ; SEPARATE destroy flagon	beaker : c c m ; thermos : r r b f b ;
decanter : m m ; urn : e e ; SEPARATE destroy urn	decanter : m m ;
bottle : c b c ; decanter : v f v e ; mug : c p ; SEPARATE destroy bottle	decanter : v f v e ; mug : c p ;
decanter : p ; vessel : e p ; SEPARATE destroy decanter	vessel : e p ;
flagon : v ; mug : r r ; SEPARATE destroy mug	flagon : v ;
flagon : h h ; glass : y y ; vessel : e e ; SEPARATE destroy flagon	glass : y y ; vessel : e e ;
jug : b b ; decanter : y h h ; SEPARATE destroy jug	decanter : y h h ;
flask : h ; jar : a f f a y ; flask : m m h ; SEPARATE destroy first flask	jar : a f f a y ; flask : m m h ;
flask : m m ; bottle : e a ; jar : o g g ; SEPARATE destroy flask	bottle : e a ; jar : o g g ;
beaker : m m c c ; cup : r f ; flask : g g h ; jar : h ; SEPARATE destroy beaker	cup : r f ; flask : g g h ; jar : h ;
glass : h ; flask : a f f ; flask : b y m y ; SEPARATE destroy first flask	glass : h ; flask : b y m y ;
burette : o ; mug : v v ; canister : c b b ; flask : p ; SEPARATE destroy burette	mug : v v ; canister : c b b ; flask : p ;
burette : v v ; canister : b m d ; canister : g g f f ; SEPARATE destroy last canister	burette : v v ; canister : b m d ;
canister : y y ; flask : h h e e ; SEPARATE destroy flask	canister : y y ;
bottle : m d d m ; beaker : h d h ; SEPARATE destroy beaker	bottle : m d d m ;
bottle : o y o y ; jar : b b ; flagon : g g y b ; SEPARATE destroy bottle	jar : b b ; flagon : g g y b ;
bottle : a d ; flagon : p m g m g ; SEPARATE destroy flagon	bottle : a d ;
jar : r y r h y ; jug : d d ; burette : h a a ; SEPARATE destroy burette	jar : r y r h y ; jug : d d ;
beaker : r ; vessel : p v y v ; mug : c f ; canister : g g ; SEPARATE destroy canister	beaker : r ; vessel : p v y v ; mug : c f ;
flagon : y r ; pitcher : y ; glass : a e a ; SEPARATE destroy flagon	pitcher : y ; glass : a e a ;
pitcher : d c c ; beaker : f ; pitcher : p o b o b ; SEPARATE destroy first pitcher	beaker : f ; pitcher : p o b o b ;
flagon : c m m ; thermos : e p e a p a ; flagon : v ; SEPARATE destroy first flagon	thermos : e p e a p a ; flagon : v ;
beaker : r r b ; urn : v v e e f ; SEPARATE destroy urn	beaker : r r b ;
thermos : m m g ; pitcher : v v a a ; SEPARATE destroy pitcher	thermos : m m g ;
jar : p ; cup : b ; flask : b r r ; pitcher : b b ; SEPARATE destroy jar	cup : b ; flask : b r r ; pitcher : b b ;
thermos : v y v d ; flask : r g ; SEPARATE destroy thermos	flask : r g ;
mug : a d ; beaker : v v ; jug : h ; SEPARATE destroy jug	mug : a d ; beaker : v v ;
burette : c e e ; decanter : h ; thermos : g d d c c ; SEPARATE destroy thermos	burette : c e e ; decanter : h ;
canister : a b ; flagon : o h b ; SEPARATE destroy flagon	canister : a b ;
jar : p p r ; thermos : h m m f ; SEPARATE destroy thermos	jar : p p r ;
jug : m e m e o o ; urn : g d m g m ; SEPARATE destroy jug	urn : g d m g m ;
pitcher : y ; urn : e ; SEPARATE destroy pitcher	urn : e ;
cup : h y ; decanter : a ; SEPARATE destroy cup	decanter : a ;
canister : p ; jar : y ; SEPARATE destroy canister	jar : y ;
canister : f f ; flagon : h r h r ; SEPARATE destroy flagon	canister : f f ;
glass : p p ; mug : h h ; flagon : p p ; pitcher : a ; SEPARATE destroy glass	mug : h h ; flagon : p p ; pitcher : a ;
beaker : f o f d ; canister : a f f ; jug : m b b ; SEPARATE destroy jug	beaker : f o f d ; canister : a f f ;
decanter : v ; mug : r h p p ; urn : p v p v ; SEPARATE destroy mug	decanter : v ; urn : p v p v ;
canister : y y p ; beaker : y y p p ; SEPARATE destroy canister	beaker : y y p p ;
cup : h h y ; flagon : b ; beaker : o o ; SEPARATE destroy cup	flagon : b ; beaker : o o ;
pitcher : f g v f ; burette : c ; canister : c v c y v ; SEPARATE destroy pitcher	burette : c ; canister : c v c y v ;
pitcher : p p ; canister : v v ; SEPARATE destroy canister	pitcher : p p ;
cup : d ; jug : r ; SEPARATE destroy jug	cup : d ;
urn : m m r r ; pitcher : p o o p ; SEPARATE destroy urn	pitcher : p o o p ;
burette : d p ; bottle : c c e e p p ; glass : v v ; SEPARATE destroy burette	bottle : c c e e p p ; glass : v v ;
pitcher : e r e r ; vessel : y y ; SEPARATE destroy vessel	pitcher : e r e r ;
pitcher : d e d f e ; mug : h h ; SEPARATE destroy mug	pitcher : d e d f e ;
bottle : h r r f ; jar : f r y ; SEPARATE destroy jar	bottle : h r r f ;
pitcher : y h f f y ; canister : v ; glass : v ; SEPARATE destroy pitcher	canister : v ; glass : v ;
glass : y ; bottle : y y ; SEPARATE destroy bottle	glass : y ;
burette : a ; jug : h b b a h ; SEPARATE destroy burette	jug : h b b a h ;
vessel : d b f d f ; flask : a o f f a ; jar : f ; SEPARATE destroy vessel	flask : a o f f a ; jar : f ;
thermos : e c c y y e ; vessel : c c o e ; SEPARATE destroy thermos	vessel : c c o e ;
urn : f a h a f ; decanter : m m h c h ; SEPARATE destroy urn	decanter : m m h c h ;
pitcher : v v y ; beaker : r e r d ; SEPARATE destroy beaker	pitcher : v v y ;
cup : c c ; burette : o v v o ; SEPARATE destroy cup	burette : o v v o ;
cup : v f f v ; cup : o o ; decanter : r r m y ; SEPARATE destroy decanter	cup : v f f v ; cup : o o ;
thermos : f b b o ; jug : h c b b h ; SEPARATE destroy thermos	jug : h c b b h ;
thermos : y h g y ; cup : o f ; canister : v a v a ; SEPARATE destroy thermos	cup : o f ; canister : v a v a ;
pitcher : e a ; vessel : c d d ; SEPARATE destroy pitcher	vessel : c d d ;
mug : b v v b o ; thermos : p b y b ; SEPARATE destroy mug	thermos : p b y b ;
decanter : r c ; jug : m e g m g ; SEPARATE destroy decanter	jug : m e g m g ;
bottle : y c c y ; cup : h ; flask : p b ; jar : e e ; SEPARATE destroy bottle	cup : h ; flask : p b ; jar : e e ;
glass : c d c r d ; bottle : e ; burette : b b m r ; SEPARATE destroy burette	glass : c d c r d ; bottle : e ;
cup : c ; jar : h h ; canister : m e c ; thermos : e e ; SEPARATE destroy cup	jar : h h ; canister : m e c ; thermos : e e ;
pitcher : m d ; vessel : m ; SEPARATE destroy vessel	pitcher : m d ;
burette : h g h ; glass : d ; jar : p f f ; SEPARATE destroy glass	burette : h g h ; jar : p f f ;
thermos : m m ; urn : v y y ; vessel : v d d m ; SEPARATE destroy vessel	thermos : m m ; urn : v y y ;
pitcher : b y y ; jar : o y o d ; canister : c ; SEPARATE destroy jar	pitcher : b y y ; canister : c ;
thermos : b e b e ; beaker : f o o f ; SEPARATE destroy beaker	thermos : b e b e ;
mug : f g d d g ; pitcher : b ; beaker : h r h ; SEPARATE destroy beaker	mug : f g d d g ; pitcher : b ;
jar : r r ; burette : p p f e ; SEPARATE destroy jar	burette : p p f e ;
burette : e e o ; cup : g g c ; SEPARATE destroy cup	burette : e e o ;
decanter : p ; decanter : a ; SEPARATE destroy first decanter	decanter : a ;
bottle : v v a a ; flagon : r r m m ; bottle : h v v ; SEPARATE destroy first bottle	flagon : r r m m ; bottle : h v v ;
pitcher : f d f b ; urn : p ; glass : f g d f ; SEPARATE destroy glass	pitcher : f d f b ; urn : p ;
jug : h o ; pitcher : y ; burette : g g e v ; SEPARATE destroy jug	pitcher : y ; burette : g g e v ;
flask : c m v c m v ; canister : a ; SEPARATE destroy canister	flask : c m v c m v ;
beaker : a y y h ; mug : r c c r ; bottle : p ; SEPARATE destroy bottle	beaker : a y y h ; mug : r c c r ;
glass : o a o a y y ; urn : p p ; SEPARATE destroy glass	urn : p p ;
urn : o o ; urn : f f c ; SEPARATE destroy first urn	urn : f f c ;
bottle : v ; pitcher : v v ; SEPARATE destroy pitcher	bottle : v ;
jar : o o ; flask : o a c ; urn : y y f ; SEPARATE destroy flask	jar : o o ; urn : y y f ;
urn : d ; beaker : p d d ; SEPARATE destroy beaker	urn : d ;
bottle : m ; flagon : p p d ; beaker : g ; SEPARATE destroy beaker	bottle : m ; flagon : p p d ;
cup : r ; jug : o o ; SEPARATE destroy cup	jug : o o ;
cup : h ; flagon : p g ; SEPARATE destroy flagon	cup : h ;
burette : c ; urn : v m v b ; SEPARATE destroy burette	urn : v m v b ;
jug : c c ; bottle : a a o g ; SEPARATE destroy bottle	jug : c c ;
vessel : c e b c b ; canister : d a a p ; SEPARATE destroy vessel	canister : d a a p ;
jar : c r r c a a ; bottle : r ; SEPARATE destroy jar	bottle : r ;
thermos : d ; beaker : h h e d e ; vessel : o o ; SEPARATE destroy thermos	beaker : h h e d e ; vessel : o o ;
flagon : v v ; canister : e e c c ; SEPARATE destroy canister	flagon : v v ;
glass : d b ; glass : r e r e b b ; SEPARATE destroy last glass	glass : d b ;
bottle : y y ; urn : d ; SEPARATE destroy urn	bottle : y y ;
decanter : c d c ; mug : p p c ; SEPARATE destroy decanter	mug : p p c ;
bottle : r r ; jug : e p e ; thermos : y r r y ; SEPARATE destroy jug	bottle : r r ; thermos : y r r y ;
decanter : b b v v ; jar : r ; vessel : h p ; SEPARATE destroy vessel	decanter : b b v v ; jar : r ;
beaker : p p ; mug : m h m h ; SEPARATE destroy mug	beaker : p p ;
pitcher : y a g y ; flask : g f ; pitcher : b b ; SEPARATE destroy flask	pitcher : y a g y ; pitcher : b b ;
bottle : f f g ; bottle : b b a ; SEPARATE destroy last bottle	bottle : f f g ;
pitcher : y y ; glass : h d h d ; canister : r r ; SEPARATE destroy pitcher	glass : h d h d ; canister : r r ;
canister : p ; beaker : b y o ; jar : b y c ; SEPARATE destroy jar	canister : p ; beaker : b y o ;
flask : d d ; flask : g ; mug : g g ; SEPARATE destroy mug	flask : d d ; flask : g ;
pitcher : v v e ; thermos : p p h ; flask : c c ; SEPARATE destroy pitcher	thermos : p p h ; flask : c c ;
vessel : h f ; vessel : v v ; flagon : m b ; SEPARATE destroy last vessel	vessel : h f ; flagon : m b ;
pitcher : p p ; mug : m m a a ; SEPARATE destroy mug	pitcher : p p ;
flask : a o o a ; vessel : y a y h ; SEPARATE destroy vessel	flask : a o o a ;
burette : v h v ; bottle : h h p ; SEPARATE destroy burette	bottle : h h p ;
flask : g ; canister : r r b ; SEPARATE destroy canister	flask : g ;
cup : g o g o ; urn : g g ; beaker : g y y g ; SEPARATE destroy cup	urn : g g ; beaker : g y y g ;
cup : v v c ; jar : f f o p ; cup : m ; SEPARATE destroy second cup	cup : v v c ; jar : f f o p ;
jug : g g ; jar : a a ; vessel : y y g g ; SEPARATE destroy jar	jug : g g ; vessel : y y g g ;
decanter : d e ; jug : d r f ; burette : y h ; cup : h ; SEPARATE destroy jug	decanter : d e ; burette : y h ; cup : h ;
bottle : a g b ; bottle : r r ; canister : c g g b ; SEPARATE destroy canister	bottle : a g b ; bottle : r r ;
vessel : a ; pitcher : v ; SEPARATE destroy pitcher	vessel : a ;
mug : f f p ; glass : f o o y ; SEPARATE destroy glass	mug : f f p ;
pitcher : b b ; bottle : y f y m ; pitcher : e o ; SEPARATE destroy bottle	pitcher : b b ; pitcher : e o ;
jar : v ; urn : v e ; pitcher : d b d c ; beaker : c ; SEPARATE destroy pitcher	jar : v ; urn : v e ; beaker : c ;
canister : b b ; mug : h m o o ; flagon : f f ; flask : h ; SEPARATE destroy flagon	canister : b b ; mug : h m o o ; flask : h ;
jug : r r ; burette : d d a a ; SEPARATE destroy jug	burette : d d a a ;
flagon : c r v ; decanter : p p e y y e ; vessel : p v ; SEPARATE destroy vessel	flagon : c r v ; decanter : p p e y y e ;
bottle : y a a o y ; jug : c c b b ; mug : r c ; SEPARATE destroy jug	bottle : y a a o y ; mug : r c ;
mug : d h c ; pitcher : y ; SEPARATE destroy pitcher	mug : d h c ;
flagon : f e r ; jug : a f e f a ; jug : r ; SEPARATE destroy last jug	flagon : f e r ; jug : a f e f a ;
glass : v ; burette : a f f o ; SEPARATE destroy glass	burette : a f f o ;
thermos : c o g o c ; bottle : v c v ; SEPARATE destroy thermos	bottle : v c v ;
thermos : g g m e m ; decanter : v ; bottle : c ; SEPARATE destroy thermos	decanter : v ; bottle : c ;
decanter : h h ; burette : b p b ; SEPARATE destroy burette	decanter : h h ;
flask : e y y ; mug : p r e e ; SEPARATE destroy mug	flask : e y y ;
glass : o o f h ; thermos : y b o o ; SEPARATE destroy thermos	glass : o o f h ;
jug : e ; jug : c b b c ; SEPARATE destroy second jug	jug : e ;
glass : a a ; beaker : p f p f ; jar : p p o ; SEPARATE destroy glass	beaker : p f p f ; jar : p p o ;
bottle : p p f f ; flask : b ; pitcher : d ; SEPARATE destroy pitcher	bottle : p p f f ; flask : b ;
flagon : e g h h g ; decanter : b v b ; SEPARATE destroy decanter	flagon : e g h h g ;
burette : r r ; glass : c d ; urn : h h ; SEPARATE destroy urn	burette : r r ; glass : c d ;
cup : o o ; thermos : y ; pitcher : v v ; jar : p d r p ; SEPARATE destroy jar	cup : o o ; thermos : y ; pitcher : v v ;
flask : c ; cup : o d o r ; SEPARATE destroy cup	flask : c ;
cup : g ; jar : a a ; mug : a m ; SEPARATE destroy mug	cup : g ; jar : a a ;
bottle : r o g ; decanter : v v r ; burette : e r h e ; SEPARATE destroy burette	bottle : r o g ; decanter : v v r ;
flagon : h ; canister : e f ; glass : g b g h ; bottle : v v ; SEPARATE destroy flagon	canister : e f ; glass : g b g h ; bottle : v v ;
canister : d y y ; cup : e c e ; SEPARATE destroy cup	canister : d y y ;
jar : v a a ; burette : p p ; jar : r ; SEPARATE destroy burette	jar : v a a ; jar : r ;
jar : r c ; urn : m o o v m ; SEPARATE destroy urn	jar : r c ;
flagon : a o b o a ; pitcher : d r r ; flask : e e y y ; SEPARATE destroy pitcher	flagon : a o b o a ; flask : e e y y ;
beaker : v m m p ; cup : d d ; SEPARATE destroy cup	beaker : v m m p ;
flask : p e ; urn : g p y ; canister : a a ; flagon : a f ; SEPARATE destroy canister	flask : p e ; urn : g p y ; flagon : a f ;
jug : a ; pitcher : f f e m m ; thermos : r g g r ; SEPARATE destroy jug	pitcher : f f e m m ; thermos : r g g r ;
jar : a a ; cup : d ; jar : r ; SEPARATE destroy first jar	cup : d ; jar : r ;
flagon : f c ; flagon : a e o a e ; thermos : o ; SEPARATE destroy second flagon	flagon : f c ; thermos : o ;
flask : e c b b e c ; jar : h h ; jug : b a a ; SEPARATE destroy flask	jar : h h ; jug : b a a ;
decanter : f f ; canister : g v v y ; vessel : y y ; SEPARATE destroy vessel	decanter : f f ; canister : g v v y ;
mug : f f d d p p ; beaker : e h m ; vessel : m e ; SEPARATE destroy beaker	mug : f f d d p p ; vessel : m e ;
jug : p p d d ; burette : e e d ; SEPARATE destroy burette	jug : p p d d ;
urn : e e ; decanter : h h ; SEPARATE destroy decanter	urn : e e ;
flask : d e e ; thermos : h y y ; SEPARATE destroy thermos	flask : d e e ;
pitcher : d d r r ; canister : b h b c ; mug : a ; SEPARATE destroy mug	pitcher : d d r r ; canister : b h b c ;
flask : e m y y m e ; mug : c c b ; SEPARATE destroy flask	mug : c c b ;
urn : a a ; pitcher : f f ; SEPARATE destroy pitcher	urn : a a ;
pitcher : a b b ; flagon : g r g r ; SEPARATE destroy flagon	pitcher : a b b ;
jug : e m d ; urn : e e r ; beaker : m f m a ; SEPARATE destroy beaker	jug : e m d ; urn : e e r ;
flagon : o c ; urn : m v v d d ; vessel : m ; SEPARATE destroy vessel	flagon : o c ; urn : m v v d d ;
urn : e ; flask : m m ; SEPARATE destroy urn	flask : m m ;
burette : e m e m ; decanter : d c c ; bottle : g m r ; SEPARATE destroy decanter	burette : e m e m ; bottle : g m r ;
jug : f b f g ; flagon : g c g c d d ; thermos : d d ; SEPARATE destroy flagon	jug : f b f g ; thermos : d d ;
urn : a d h h ; cup : b h ; SEPARATE destroy urn	cup : b h ;
canister : o o ; pitcher : e p m m ; flask : c c y ; SEPARATE destroy canister	pitcher : e p m m ; flask : c c y ;
thermos : c a ; burette : r r ; SEPARATE destroy thermos	burette : r r ;
glass : v v ; canister : g ; SEPARATE destroy canister	glass : v v ;
flask : r r ; flask : p ; SEPARATE destroy first flask	flask : p ;
mug : a ; glass : d d ; SEPARATE destroy glass	mug : a ;
cup : r ; cup : h c c h ; cup : e c h ; SEPARATE destroy first cup	cup : h c c h ; cup : e c h ;
beaker : f e e ; thermos : p ; SEPARATE destroy thermos	beaker : f e e ;
bottle : r p v ; jug : b y y b ; pitcher : m ; SEPARATE destroy bottle	jug : b y y b ; pitcher : m ;
mug : h d d ; jar : e e b g g ; thermos : a ; SEPARATE destroy jar	mug : h d d ; thermos : a ;
cup : p ; cup : d r v ; SEPARATE destroy first cup	cup : d r v ;
flagon : f f ; beaker : m m p ; vessel : m m g d ; SEPARATE destroy flagon	beaker : m m p ; vessel : m m g d ;
burette : p p ; glass : p p m m ; SEPARATE destroy glass	burette : p p ;
bottle : a a ; decanter : a d ; SEPARATE destroy decanter	bottle : a a ;
mug : d d ; thermos : d g g h ; flagon : p p y ; SEPARATE destroy thermos	mug : d d ; flagon : p p y ;
vessel : e e b ; bottle : v y g ; bottle : o ; jug : v v ; SEPARATE destroy jug	vessel : e e b ; bottle : v y g ; bottle : o ;
decanter : p p ; canister : e o e g g ; flagon : g h r r ; SEPARATE destroy flagon	decanter : p p ; canister : e o e g g ;
mug : c c ; pitcher : g f g o ; pitcher : e g e g ; SEPARATE destroy first pitcher	mug : c c ; pitcher : e g e g ;
flagon : f g r g r ; cup : r r ; SEPARATE destroy cup	flagon : f g r g r ;
glass : d m ; bottle : m m ; bottle : b f f a a ; SEPARATE destroy second bottle	glass : d m ; bottle : m m ;
glass : a p ; mug : c h ; beaker : o ; SEPARATE destroy beaker	glass : a p ; mug : c h ;
jar : g g h h ; jug : m ; SEPARATE destroy jug	jar : g g h h ;
mug : v v ; flagon : d d r e ; SEPARATE destroy mug	flagon : d d r e ;
flagon : a a ; jug : p f c p ; pitcher : o f p f ; SEPARATE destroy flagon	jug : p f c p ; pitcher : o f p f ;
jug : a c v c v ; jar : g r d d r ; SEPARATE destroy jar	jug : a c v c v ;
burette : m b a a ; thermos : d y d ; SEPARATE destroy thermos	burette : m b a a ;
flask : o r r ; pitcher : h g a h ; SEPARATE destroy pitcher	flask : o r r ;
flagon : m y y ; decanter : o p y p y ; jug : d y d v ; SEPARATE destroy flagon	decanter : o p y p y ; jug : d y d v ;
flask : g e ; canister : o e g e o ; SEPARATE destroy flask	canister : o e g e o ;
pitcher : b d d b ; flask : y g r g r y ; SEPARATE destroy flask	pitcher : b d d b ;
glass : p ; bottle : v v ; thermos : m m ; urn : c c ; SEPARATE destroy glass	bottle : v v ; thermos : m m ; urn : c c ;
pitcher : r c r c ; bottle : h e h e ; SEPARATE destroy pitcher	bottle : h e h e ;
decanter : c v v ; glass : e c o o ; SEPARATE destroy decanter	glass : e c o o ;
pitcher : o o a ; flagon : v ; flask : y e e ; SEPARATE destroy flask	pitcher : o o a ; flagon : v ;
vessel : e e ; decanter : g g b ; beaker : b f b o f ; SEPARATE destroy beaker	vessel : e e ; decanter : g g b ;
vessel : p g m ; jar : m e m ; SEPARATE destroy jar	vessel : p g m ;
mug : g o ; canister : p y p ; SEPARATE destroy mug	canister : p y p ;
beaker : a a p ; decanter : y p y ; SEPARATE destroy beaker	decanter : y p y ;
urn : r m ; beaker : h h ; mug : m m ; SEPARATE destroy urn	beaker : h h ; mug : m m ;
bottle : m m ; flagon : f f b ; SEPARATE destroy flagon	bottle : m m ;
jug : e e ; jar : m m ; mug : a p ; SEPARATE destroy jug	jar : m m ; mug : a p ;
bottle : y y ; pitcher : c a c e a ; decanter : r ; SEPARATE destroy decanter	bottle : y y ; pitcher : c a c e a ;
pitcher : c f f c b b ; glass : d m c ; SEPARATE destroy glass	pitcher : c f f c b b ;
vessel : p b b ; mug : o o ; jug : h h ; SEPARATE destroy vessel	mug : o o ; jug : h h ;
urn : f ; thermos : o c d o ; decanter : f ; SEPARATE destroy urn	thermos : o c d o ; decanter : f ;
urn : d c c d ; thermos : c ; SEPARATE destroy thermos	urn : d c c d ;
glass : h m ; cup : b ; mug : b f b h ; canister : d d ; SEPARATE destroy glass	cup : b ; mug : b f b h ; canister : d d ;
beaker : m ; pitcher : c c ; SEPARATE destroy beaker	pitcher : c c ;
decanter : m h p p ; urn : f f ; vessel : h r e r h ; SEPARATE destroy urn	decanter : m h p p ; vessel : h r e r h ;
jug : d ; decanter : r f m f ; cup : e e ; bottle : g ; SEPARATE destroy jug	decanter : r f m f ; cup : e e ; bottle : g ;
jar : c ; cup : m ; bottle : g g ; SEPARATE destroy jar	cup : m ; bottle : g g ;
jar : a m r r ; burette : y y ; SEPARATE destroy jar	burette : y y ;
mug : o o ; burette : f ; glass : g v g ; vessel : m v m ; SEPARATE destroy vessel	mug : o o ; burette : f ; glass : g v g ;
thermos : h h ; flagon : d d ; beaker : g ; SEPARATE destroy thermos	flagon : d d ; beaker : g ;
glass : b y y b m ; jar : d d m ; SEPARATE destroy jar	glass : b y y b m ;
jar : o o ; urn : e v v o ; SEPARATE destroy jar	urn : e v v o ;
burette : r r ; beaker : a r y a ; SEPARATE destroy burette	beaker : a r y a ;
burette : d v d c ; flagon : p d b p d ; SEPARATE destroy burette	flagon : p d b p d ;
beaker : e b c c ; glass : m d a a d ; SEPARATE destroy glass	beaker : e b c c ;
cup : m e f f m ; burette : e c b e b ; SEPARATE destroy burette	cup : m e f f m ;
thermos : o a d o ; burette : m m y ; SEPARATE destroy burette	thermos : o a d o ;
glass : a a ; mug : a a ; SEPARATE destroy glass	mug : a a ;
flagon : e ; bottle : o ; thermos : p p ; SEPARATE destroy flagon	bottle : o ; thermos : p p ;
thermos : e e m ; beaker : h e g h g ; SEPARATE destroy beaker	thermos : e e m ;
vessel : a m a m ; canister : m r r m ; SEPARATE destroy vessel	canister : m r r m ;
glass : b h h b ; flagon : p ; mug : g g ; SEPARATE destroy mug	glass : b h h b ; flagon : p ;
vessel : c ; urn : h ; thermos : b ; SEPARATE destroy thermos	vessel : c ; urn : h ;
bottle : d d c ; canister : h g h a g ; SEPARATE destroy canister	bottle : d d c ;
urn : r r g g ; flagon : y p r ; SEPARATE destroy urn	flagon : y p r ;
burette : b b c ; mug : c r b ; SEPARATE destroy mug	burette : b b c ;
flask : h h ; jug : g ; flask : p ; SEPARATE destroy first flask	jug : g ; flask : p ;
flask : h e o e ; pitcher : c b b ; SEPARATE destroy pitcher	flask : h e o e ;
decanter : h g g ; vessel : d o v o ; SEPARATE destroy decanter	vessel : d o v o ;
thermos : d d ; burette : a a ; bottle : e e g ; canister : g ; SEPARATE destroy burette	thermos : d d ; bottle : e e g ; canister : g ;
vessel : b b y y ; burette : m ; SEPARATE destroy burette	vessel : b b y y ;
decanter : b b ; beaker : g b g a a ; SEPARATE destroy beaker	decanter : b b ;
cup : c ; pitcher : g g ; cup : e e ; jug : r d ; SEPARATE destroy first cup	pitcher : g g ; cup : e e ; jug : r d ;
flask : g g y ; flagon : p ; SEPARATE destroy flask	flagon : p ;
cup : e b f f b e ; beaker : c ; SEPARATE destroy beaker	cup : e b f f b e ;
cup : o o ; pitcher : e d d ; SEPARATE destroy cup	pitcher : e d d ;
burette : b b ; flask : g e g ; mug : v r ; SEPARATE destroy burette	flask : g e g ; mug : v r ;
thermos : e e ; jar : p p b ; SEPARATE destroy thermos	jar : p p b ;
flagon : b r r h b ; flask : d g ; mug : y y ; SEPARATE destroy flagon	flask : d g ; mug : y y ;
thermos : f m f m ; flagon : d d g g ; SEPARATE destroy thermos	flagon : d d g g ;
vessel : e o e ; decanter : r ; SEPARATE destroy decanter	vessel : e o e ;
pitcher : o v o g v ; jug : y d d g g ; SEPARATE destroy pitcher	jug : y d d g g ;
decanter : p p ; mug : y ; SEPARATE destroy decanter	mug : y ;
glass : p m m ; urn : v o v ; bottle : r g g p r ; SEPARATE destroy urn	glass : p m m ; bottle : r g g p r ;
jar : v v ; jar : y ; thermos : b ; SEPARATE destroy last jar	jar : v v ; thermos : b ;
decanter : y f f y g ; urn : v y v y r ; SEPARATE destroy decanter	urn : v y v y r ;
glass : v m m h h ; flask : e m e m ; burette : r ; SEPARATE destroy glass	flask : e m e m ; burette : r ;
canister : r b r ; glass : c h h c ; SEPARATE destroy glass	canister : r b r ;
bottle : y e e ; canister : o r b b r ; SEPARATE destroy bottle	canister : o r b b r ;
glass : e ; decanter : o h o m h m ; SEPARATE destroy decanter	glass : e ;
beaker : m d m ; decanter : r ; SEPARATE destroy beaker	decanter : r ;
jar : m ; canister : g o ; SEPARATE destroy canister	jar : m ;
thermos : o o ; canister : m a f f m ; decanter : b b o ; SEPARATE destroy decanter	thermos : o o ; canister : m a f f m ;
beaker : m m a a ; beaker : e o ; vessel : g e y g ; SEPARATE destroy vessel	beaker : m m a a ; beaker : e o ;
pitcher : e h o o ; glass : e ; SEPARATE destroy glass	pitcher : e h o o ;
jug : m m y ; burette : f f ; SEPARATE destroy burette	jug : m m y ;
beaker : v m ; vessel : b ; SEPARATE destroy beaker	vessel : b ;
thermos : r m m ; bottle : e g v e ; glass : v b o v ; SEPARATE destroy thermos	bottle : e g v e ; glass : v b o v ;
bottle : d d ; mug : m ; SEPARATE destroy bottle	mug : m ;
canister : c a c a ; flask : r p ; SEPARATE destroy canister	flask : r p ;
pitcher : a ; jug : d p d p ; jar : f f ; burette : v ; SEPARATE destroy burette	pitcher : a ; jug : d p d p ; jar : f f ;
mug : f ; glass : v v h h ; bottle : c ; pitcher : d d y ; SEPARATE destroy mug	glass : v v h h ; bottle : c ; pitcher : d d y ;
beaker : h m b b h ; thermos : v v ; thermos : v b v ; SEPARATE destroy beaker	thermos : v v ; thermos : v b v ;
vessel : y b d b ; burette : c c ; urn : y e h e h y ; SEPARATE destroy urn	vessel : y b d b ; burette : c c ;
burette : d y ; decanter : d d b ; SEPARATE destroy decanter	burette : d y ;
flask : e g g ; flask : y ; SEPARATE destroy last flask	flask : e g g ;
burette : e ; burette : c c ; glass : b b e v e v ; SEPARATE destroy glass	burette : e ; burette : c c ;
beaker : r o v ; flagon : e m ; SEPARATE destroy beaker	flagon : e m ;
jar : a ; thermos : a ; cup : v v ; SEPARATE destroy cup	jar : a ; thermos : a ;
urn : c e e ; decanter : a a f ; flagon : m ; decanter : g c ; SEPARATE destroy urn	decanter : a a f ; flagon : m ; decanter : g c ;
urn : o ; burette : a a ; SEPARATE destroy urn	burette : a a ;
beaker : m m ; jar : h h ; SEPARATE destroy beaker	jar : h h ;
jug : e e ; decanter : o f f v ; SEPARATE destroy jug	decanter : o f f v ;
mug : a a c ; vessel : a a ; SEPARATE destroy mug	vessel : a a ;
jug : c c ; glass : f o ; SEPARATE destroy jug	glass : f o ;
canister : a g p g p ; decanter : p h r r ; SEPARATE destroy canister	decanter : p h r r ;
vessel : b g d b g d ; flask : a a ; SEPARATE destroy flask	vessel : b g d b g d ;
decanter : d b ; urn : o c r r c ; SEPARATE destroy urn	decanter : d b ;
flagon : e ; jar : m c e e ; SEPARATE destroy flagon	jar : m c e e ;
flask : d d ; canister : f r ; SEPARATE destroy canister	flask : d d ;
burette : r r ; urn : v ; flagon : b b m ; SEPARATE destroy urn	burette : r r ; flagon : b b m ;
burette : p d p ; flagon : f f g ; pitcher : b y y ; SEPARATE destroy burette	flagon : f f g ; pitcher : b y y ;
decanter : d v d ; vessel : o h o h ; SEPARATE destroy decanter	vessel : o h o h ;
flask : f f p ; jar : v v r y r ; SEPARATE destroy jar	flask : f f p ;
jar : p y h h ; bottle : f ; flagon : b b ; canister : m g ; SEPARATE destroy canister	jar : p y h h ; bottle : f ; flagon : b b ;
flagon : b b h ; mug : r g r ; glass : y y v r r ; SEPARATE destroy glass	flagon : b b h ; mug : r g r ;
bottle : o f o f ; urn : c r r a a ; SEPARATE destroy urn	bottle : o f o f ;
burette : o ; thermos : p p e ; mug : b b a g g ; SEPARATE destroy thermos	burette : o ; mug : b b a g g ;
jar : b ; thermos : y f g y g ; SEPARATE destroy thermos	jar : b ;
urn : p p ; thermos : g g y ; beaker : d d e ; SEPARATE destroy thermos	urn : p p ; beaker : d d e ;
jar : p ; glass : b b ; mug : h h f ; SEPARATE destroy glass	jar : p ; mug : h h f ;
beaker : p ; flagon : y y ; SEPARATE destroy beaker	flagon : y y ;
thermos : p p h h ; canister : c f f c ; glass : o m v m ; SEPARATE destroy glass	thermos : p p h h ; canister : c f f c ;
flask : o g h o h ; canister : r r ; SEPARATE destroy canister	flask : o g h o h ;
thermos : g y o ; urn : c c y ; SEPARATE destroy thermos	urn : c c y ;
jar : d ; canister : m a ; jug : o o c c ; canister : g g ; SEPARATE destroy jar	canister : m a ; jug : o o c c ; canister : g g ;
vessel : g e o o ; glass : v e v ; canister : m m ; SEPARATE destroy glass	vessel : g e o o ; canister : m m ;
cup : g g ; thermos : r a ; jar : v b b v ; SEPARATE destroy jar	cup : g g ; thermos : r a ;
flask : o ; vessel : m m ; glass : h h c d ; flagon : y y ; SEPARATE destroy vessel	flask : o ; glass : h h c d ; flagon : y y ;
vessel : r a r b b a ; beaker : g g o o ; SEPARATE destroy beaker	vessel : r a r b b a ;
pitcher : h h p ; canister : c p ; mug : y m m ; SEPARATE destroy canister	pitcher : h h p ; mug : y m m ;
pitcher : c g c ; canister : d c c g ; SEPARATE destroy canister	pitcher : c g c ;
thermos : y y ; bottle : p d d p ; SEPARATE destroy thermos	bottle : p d d p ;
thermos : g a g a ; canister : h ; SEPARATE destroy thermos	canister : h ;
canister : m p h ; jug : c m c ; flask : c c r f ; SEPARATE destroy flask	canister : m p h ; jug : c m c ;
vessel : m h m ; burette : d o b ; bottle : a a ; thermos : r ; SEPARATE destroy vessel	burette : d o b ; bottle : a a ; thermos : r ;
canister : e d e o ; pitcher : c c a ; SEPARATE destroy canister	pitcher : c c a ;
canister : v ; cup : h h c c ; SEPARATE destroy cup	canister : v ;
vessel : a a g g ; flask : a d c d ; SEPARATE destroy vessel	flask : a d c d ;
glass : f d d f ; burette : p p ; SEPARATE destroy glass	burette : p p ;
decanter : b y y b e ; vessel : a r r a ; SEPARATE destroy vessel	decanter : b y y b e ;
cup : p b p h ; mug : b b ; SEPARATE destroy cup	mug : b b ;
bottle : f f c c ; thermos : c ; jug : r r ; bottle : v ; SEPARATE destroy thermos	bottle : f f c c ; jug : r r ; bottle : v ;
glass : r r ; pitcher : a r r ; SEPARATE destroy pitcher	glass : r r ;
jug : r r o ; pitcher : m h g m g ; SEPARATE destroy pitcher	jug : r r o ;
jar : c h h d d ; thermos : e v p e ; decanter : r r ; SEPARATE destroy jar	thermos : e v p e ; decanter : r r ;
thermos : p r g ; jug : a h ; urn : o o ; SEPARATE destroy thermos	jug : a h ; urn : o o ;
pitcher : y a y ; jug : b c g ; SEPARATE destroy jug	pitcher : y a y ;
thermos : f f e d d ; flagon : r r ; SEPARATE destroy thermos	flagon : r r ;
flask : a a b ; burette : f ; SEPARATE destroy burette	flask : a a b ;
cup : f f o p p ; mug : p m m p ; thermos : m m ; SEPARATE destroy cup	mug : p m m p ; thermos : m m ;
bottle : m ; beaker : y r ; cup : o o v v p ; SEPARATE destroy bottle	beaker : y r ; cup : o o v v p ;
beaker : d e ; bottle : d d ; SEPARATE destroy beaker	bottle : d d ;
pitcher : m ; urn : r f r f ; thermos : g e d e ; SEPARATE destroy urn	pitcher : m ; thermos : g e d e ;
thermos : g p g a ; mug : e r y e ; SEPARATE destroy mug	thermos : g p g a ;
mug : v c ; flask : b ; SEPARATE destroy flask	mug : v c ;
canister : y y ; burette : r ; SEPARATE destroy canister	burette : r ;
beaker : b ; urn : o ; SEPARATE destroy beaker	urn : o ;
urn : r g r g a ; flagon : o v o v h ; SEPARATE destroy flagon	urn : r g r g a ;
glass : h ; thermos : b ; thermos : g h ; urn : h m h c m ; SEPARATE destroy urn	glass : h ; thermos : b ; thermos : g h ;
burette : h p e e ; urn : g ; jug : a v a c ; SEPARATE destroy urn	burette : h p e e ; jug : a v a c ;
canister : c v v ; bottle : y ; SEPARATE destroy bottle	canister : c v v ;
burette : m m h ; glass : b h h ; SEPARATE destroy glass	burette : m m h ;
canister : d b d ; urn : g ; jug : f p p ; flagon : b b ; SEPARATE destroy canister	urn : g ; jug : f p p ; flagon : b b ;
burette : y ; jar : h h c ; flagon : p p f f ; SEPARATE destroy flagon	burette : y ; jar : h h c ;
jug : d d b b ; jug : m y m p p ; SEPARATE destroy second jug	jug : d d b b ;
pitcher : m ; jar : h f ; mug : f y f y p p ; SEPARATE destroy mug	pitcher : m ; jar : h f ;
flagon : f f ; jar : g v v g ; jug : m a y a m y ; SEPARATE destroy flagon	jar : g v v g ; jug : m a y a m y ;
flagon : p p ; mug : m m ; cup : m g g ; SEPARATE destroy flagon	mug : m m ; cup : m g g ;
decanter : b ; decanter : h y h ; SEPARATE destroy second decanter	decanter : b ;
bottle : a ; thermos : g ; SEPARATE destroy bottle	thermos : g ;
cup : d v v ; decanter : m d h m h ; SEPARATE destroy cup	decanter : m d h m h ;
cup : v m v r ; decanter : b h h ; vessel : y ; SEPARATE destroy cup	decanter : b h h ; vessel : y ;
decanter : b b f o f ; vessel : m f m ; beaker : a ; SEPARATE destroy vessel	decanter : b b f o f ; beaker : a ;
beaker : d d g g f ; urn : d v ; mug : f g f ; SEPARATE destroy urn	beaker : d d g g f ; mug : f g f ;
beaker : m c m ; decanter : f f r m r ; SEPARATE destroy beaker	decanter : f f r m r ;
canister : g d g c c d ; flask : r r m ; jug : y d d ; SEPARATE destroy jug	canister : g d g c c d ; flask : r r m ;
flagon : d d ; vessel : d d ; decanter : o ; SEPARATE destroy decanter	flagon : d d ; vessel : d d ;
thermos : y d d ; glass : f f b ; thermos : o r r e ; SEPARATE destroy glass	thermos : y d d ; thermos : o r r e ;
jar : h h ; vessel : d r ; bottle : c h a h c ; SEPARATE destroy bottle	jar : h h ; vessel : d r ;
decanter : a a m ; bottle : a a g g ; SEPARATE destroy bottle	decanter : a a m ;
burette : p c c a p ; mug : p h ; canister : d ; SEPARATE destroy canister	burette : p c c a p ; mug : p h ;
jar : m y r ; flagon : v v ; cup : y y d ; SEPARATE destroy cup	jar : m y r ; flagon : v v ;
vessel : r r e a e a ; vessel : v ; flagon : f f c v ; SEPARATE destroy second vessel	vessel : r r e a e a ; flagon : f f c v ;
jar : o f f o ; beaker : b b o e e ; SEPARATE destroy jar	beaker : b b o e e ;
canister : r r ; vessel : y g g r ; SEPARATE destroy vessel	canister : r r ;
jar : m m d b ; glass : p g ; bottle : h ; SEPARATE destroy jar	glass : p g ; bottle : h ;
canister : p p ; decanter : p b e b ; beaker : m g g ; SEPARATE destroy canister	decanter : p b e b ; beaker : m g g ;
thermos : r y ; thermos : a o a ; thermos : v v ; SEPARATE destroy third thermos	thermos : r y ; thermos : a o a ;
jug : o b g b ; thermos : p d ; urn : r b r ; SEPARATE destroy jug	thermos : p d ; urn : r b r ;
bottle : e m e ; jug : f f g ; SEPARATE destroy jug	bottle : e m e ;
cup : m m ; urn : m g m g ; SEPARATE destroy urn	cup : m m ;
jug : v d b b ; pitcher : r g y g ; SEPARATE destroy pitcher	jug : v d b b ;
flask : e p p ; flask : r r ; SEPARATE destroy last flask	flask : e p p ;
urn : o ; burette : r r h h y ; flask : p ; SEPARATE destroy burette	urn : o ; flask : p ;
glass : e ; jug : y r f y r f ; SEPARATE destroy jug	glass : e ;
jug : y e ; decanter : b ; cup : m a m a ; SEPARATE destroy jug	decanter : b ; cup : m a m a ;
burette : f f h ; bottle : y v c ; jar : o r r o ; SEPARATE destroy burette	bottle : y v c ; jar : o r r o ;
bottle : r b g g b r ; glass : h d d ; SEPARATE destroy bottle	glass : h d d ;
vessel : b c b a a ; glass : f ; bottle : h h ; SEPARATE destroy bottle	vessel : b c b a a ; glass : f ;
decanter : a a h d ; jar : b y y b ; SEPARATE destroy jar	decanter : a a h d ;
thermos : a f f a ; jar : c g m ; SEPARATE destroy jar	thermos : a f f a ;
burette : v r r v ; bottle : p ; bottle : b m b ; SEPARATE destroy second bottle	burette : v r r v ; bottle : p ;
decanter : g g f f ; bottle : h e ; SEPARATE destroy decanter	bottle : h e ;
beaker : d p d ; cup : v o o ; vessel : e e o o d ; SEPARATE destroy cup	beaker : d p d ; vessel : e e o o d ;
burette : d h ; urn : h h ; canister : r h d ; SEPARATE destroy urn	burette : d h ; canister : r h d ;
urn : g r g ; canister : v c c g v g ; SEPARATE destroy urn	canister : v c c g v g ;
decanter : r ; bottle : c r c r a a ; vessel : f ; SEPARATE destroy decanter	bottle : c r c r a a ; vessel : f ;
mug : y y ; pitcher : o ; decanter : o o p ; cup : g g ; SEPARATE destroy cup	mug : y y ; pitcher : o ; decanter : o o p ;
canister : r r ; beaker : e h y ; thermos : c b c o b ; SEPARATE destroy beaker	canister : r r ; thermos : c b c o b ;
flask : e e ; decanter : h g g h ; flagon : h ; SEPARATE destroy decanter	flask : e e ; flagon : h ;
jug : m a d m d a ; thermos : o o ; SEPARATE destroy thermos	jug : m a d m d a ;
vessel : d ; decanter : y y ; beaker : d ; SEPARATE destroy vessel	decanter : y y ; beaker : d ;
cup : b m b ; cup : h h ; SEPARATE destroy second cup	cup : b m b ;
vessel : v c v ; mug : v v ; jug : o o f ; SEPARATE destroy vessel	mug : v v ; jug : o o f ;
bottle : a h h ; bottle : y m m ; vessel : c o o ; SEPARATE destroy vessel	bottle : a h h ; bottle : y m m ;
vessel : g v ; glass : o r ; vessel : e e ; bottle : h h ; SEPARATE destroy bottle	vessel : g v ; glass : o r ; vessel : e e ;
thermos : o ; bottle : d d o b ; SEPARATE destroy bottle	thermos : o ;
mug : b o b a ; burette : p p ; SEPARATE destroy mug	burette : p p ;
burette : e e ; mug : r ; SEPARATE destroy mug	burette : e e ;
jug : c c ; cup : c m m ; SEPARATE destroy cup	jug : c c ;
thermos : o o ; vessel : a e ; SEPARATE destroy thermos	vessel : a e ;
jug : b p ; cup : f c g c f ; flagon : p r b b p ; SEPARATE destroy cup	jug : b p ; flagon : p r b b p ;
thermos : v d d m ; bottle : v ; glass : p d p a d ; SEPARATE destroy bottle	thermos : v d d m ; glass : p d p a d ;
vessel : b b r f f ; decanter : d ; SEPARATE destroy decanter	vessel : b b r f f ;
decanter : o e o a ; thermos : r r m v ; vessel : b b f f ; SEPARATE destroy vessel	decanter : o e o a ; thermos : r r m v ;
glass : a a ; canister : c d d ; SEPARATE destroy canister	glass : a a ;
burette : o p o ; thermos : c ; SEPARATE destroy burette	thermos : c ;
pitcher : c y ; vessel : v v c c f ; canister : o b ; SEPARATE destroy pitcher	vessel : v v c c f ; canister : o b ;
canister : g g a a ; jar : y m d d ; SEPARATE destroy jar	canister : g g a a ;
pitcher : y y ; cup : h a v v ; SEPARATE destroy pitcher	cup : h a v v ;
cup : m g c ; vessel : p a o a ; SEPARATE destroy vessel	cup : m g c ;
decanter : r f r ; vessel : v y v ; pitcher : e a a v ; SEPARATE destroy vessel	decanter : r f r ; pitcher : e a a v ;
canister : r r g ; mug : m m ; urn : o g o r g r ; SEPARATE destroy canister	mug : m m ; urn : o g o r g r ;
vessel : f f ; burette : a a d ; SEPARATE destroy burette	vessel : f f ;
burette : o o g ; jar : m ; jar : p a a ; SEPARATE destroy burette	jar : m ; jar : p a a ;
thermos : p h p ; jug : f d d f ; SEPARATE destroy thermos	jug : f d d f ;
burette : o ; flagon : p ; vessel : e e ; flagon : y y ; SEPARATE destroy first flagon	burette : o ; vessel : e e ; flagon : y y ;
burette : c d m ; beaker : h ; bottle : r o o r ; SEPARATE destroy bottle	burette : c d m ; beaker : h ;
mug : p ; beaker : y m y ; glass : e ; pitcher : b b ; SEPARATE destroy beaker	mug : p ; glass : e ; pitcher : b b ;
cup : e ; beaker : y ; beaker : p p ; SEPARATE destroy cup	beaker : y ; beaker : p p ;
urn : m m p o o ; burette : f f ; SEPARATE destroy urn	burette : f f ;
decanter : p ; flagon : f v a f ; SEPARATE destroy decanter	flagon : f v a f ;
glass : y y ; vessel : h o r o ; SEPARATE destroy glass	vessel : h o r o ;
bottle : a b g g a ; glass : r r y a ; SEPARATE destroy glass	bottle : a b g g a ;
jar : d d ; beaker : v ; canister : b b ; SEPARATE destroy jar	beaker : v ; canister : b b ;
mug : f a v v ; decanter : f f m m ; SEPARATE destroy decanter	mug : f a v v ;
bottle : o d ; bottle : v p o v ; cup : e e ; SEPARATE destroy second bottle	bottle : o d ; cup : e e ;
mug : h ; jug : r y y r c ; SEPARATE destroy mug	jug : r y y r c ;
decanter : b m d b m ; burette : p y y ; SEPARATE destroy decanter	burette : p y y ;
jar : a h h g ; jar : p ; flask : y y ; SEPARATE destroy flask	jar : a h h g ; jar : p ;
jug : f f ; jug : m m ; SEPARATE destroy first jug	jug : m m ;
beaker : v ; beaker : e r ; SEPARATE destroy second beaker	beaker : v ;
vessel : v v ; urn : o d d h ; SEPARATE destroy urn	vessel : v v ;
canister : p v v ; beaker : e e f ; SEPARATE destroy canister	beaker : e e f ;
glass : f g ; decanter : r r ; burette : d y ; SEPARATE destroy glass	decanter : r r ; burette : d y ;
burette : m m ; flagon : r b b ; SEPARATE destroy burette	flagon : r b b ;
bottle : m h a ; flagon : a ; glass : e e g b ; SEPARATE destroy flagon	bottle : m h a ; glass : e e g b ;
pitcher : v v h r ; vessel : o o ; SEPARATE destroy pitcher	vessel : o o ;
jar : g ; glass : r c c ; SEPARATE destroy jar	glass : r c c ;
canister : m f ; burette : m ; flagon : b ; pitcher : r r ; SEPARATE destroy canister	burette : m ; flagon : b ; pitcher : r r ;
burette : m m ; thermos : o b o ; SEPARATE destroy burette	thermos : o b o ;
urn : e e ; cup : o v d v ; SEPARATE destroy urn	cup : o v d v ;
urn : p r ; jar : p ; SEPARATE destroy urn	jar : p ;
canister : b y ; burette : h h ; SEPARATE destroy canister	burette : h h ;
cup : o h ; bottle : b ; SEPARATE destroy cup	bottle : b ;
pitcher : v r p p r ; decanter : o v v ; SEPARATE destroy decanter	pitcher : v r p p r ;
pitcher : c d v v ; cup : e g g e ; SEPARATE destroy pitcher	cup : e g g e ;
urn : v f ; burette : r y ; SEPARATE destroy urn	burette : r y ;
glass : c ; vessel : y y d d ; glass : g y ; SEPARATE destroy first glass	vessel : y y d d ; glass : g y ;
cup : f y f ; flagon : g ; SEPARATE destroy flagon	cup : f y f ;
thermos : c ; thermos : p m m p ; canister : d d ; SEPARATE destroy canister	thermos : c ; thermos : p m m p ;
canister : y c e e y ; mug : f m f m d ; SEPARATE destroy canister	mug : f m f m d ;
jar : d d a ; decanter : m c y y ; bottle : b c c b ; SEPARATE destroy decanter	jar : d d a ; bottle : b c c b ;
glass : d p d b ; beaker : d p ; pitcher : a v f a ; SEPARATE destroy glass	beaker : d p ; pitcher : a v f a ;
glass : a ; canister : r r h h ; jug : r ; SEPARATE destroy glass	canister : r r h h ; jug : r ;
jug : y y ; burette : d o o ; SEPARATE destroy burette	jug : y y ;
canister : f g g ; decanter : o ; pitcher : v c c y v y ; SEPARATE destroy decanter	canister : f g g ; pitcher : v c c y v y ;
jug : y y ; pitcher : v ; SEPARATE destroy pitcher	jug : y y ;
glass : y ; jug : p ; SEPARATE destroy jug	glass : y ;
canister : m m ; burette : v v ; flagon : b b c c g ; SEPARATE destroy burette	canister : m m ; flagon : b b c c g ;
burette : v ; jug : v v ; decanter : p ; thermos : p p ; SEPARATE destroy burette	jug : v v ; decanter : p ; thermos : p p ;
mug : o p p ; flask : b c b d ; SEPARATE destroy mug	flask : b c b d ;
urn : c c e ; thermos : b a o a ; cup : m ; SEPARATE destroy cup	urn : c c e ; thermos : b a o a ;
burette : e e a a ; flagon : p m m y p ; SEPARATE destroy flagon	burette : e e a a ;
glass : y ; bottle : g r ; beaker : d h b ; cup : m ; SEPARATE destroy glass	bottle : g r ; beaker : d h b ; cup : m ;
decanter : o ; bottle : e y e g ; SEPARATE destroy bottle	decanter : o ;
jug : v g g ; vessel : b b h m ; bottle : v m v m o ; SEPARATE destroy jug	vessel : b b h m ; bottle : v m v m o ;
glass : b e e b o o ; jug : c v a a ; pitcher : m m ; SEPARATE destroy glass	jug : c v a a ; pitcher : m m ;
canister : p ; jug : e e ; urn : c v c v ; SEPARATE destroy jug	canister : p ; urn : c v c v ;
cup : m m ; thermos : b b ; glass : f ; SEPARATE destroy cup	thermos : b b ; glass : f ;
flagon : v d ; beaker : m g m ; burette : p ; SEPARATE destroy beaker	flagon : v d ; burette : p ;
jug : b b g ; flagon : b y y ; urn : h b b h ; SEPARATE destroy flagon	jug : b b g ; urn : h b b h ;
cup : y ; jar : c e ; cup : y y e g ; mug : b ; SEPARATE destroy jar	cup : y ; cup : y y e g ; mug : b ;
jar : g d g e ; mug : d ; flask : b v b ; SEPARATE destroy mug	jar : g d g e ; flask : b v b ;
flagon : o h ; glass : e e y ; SEPARATE destroy flagon	glass : e e y ;
thermos : v ; cup : h c m c h m ; SEPARATE destroy cup	thermos : v ;
cup : p m p r ; mug : m ; SEPARATE destroy mug	cup : p m p r ;
bottle : c c ; vessel : b h ; jar : e h p e p ; SEPARATE destroy vessel	bottle : c c ; jar : e h p e p ;
canister : f b f b ; bottle : f g f ; SEPARATE destroy canister	bottle : f g f ;
decanter : b b d ; cup : o h o d ; SEPARATE destroy decanter	cup : o h o d ;
flagon : p h h p b b ; vessel : g ; urn : g ; SEPARATE destroy urn	flagon : p h h p b b ; vessel : g ;
urn : o o a ; jug : e e ; SEPARATE destroy jug	urn : o o a ;
mug : p p v v m ; bottle : r y y r ; SEPARATE destroy mug	bottle : r y y r ;
cup : p p ; pitcher : p p ; SEPARATE destroy cup	pitcher : p p ;
urn : c r r v c ; flagon : r ; SEPARATE destroy urn	flagon : r ;
beaker : b ; canister : o r y ; urn : y y m ; SEPARATE destroy beaker	canister : o r y ; urn : y y m ;
burette : p p a ; vessel : p y f f p y ; SEPARATE destroy vessel	burette : p p a ;
glass : h p p h ; canister : y o y o ; pitcher : v ; SEPARATE destroy canister	glass : h p p h ; pitcher : v ;
mug : p p b ; glass : f y y ; jar : y y ; SEPARATE destroy mug	glass : f y y ; jar : y y ;
bottle : o ; burette : r ; SEPARATE destroy bottle	burette : r ;
mug : o a e e a o ; jar : r r ; cup : f o o ; SEPARATE destroy cup	mug : o a e e a o ; jar : r r ;
cup : d d r ; burette : e g ; SEPARATE destroy cup	burette : e g ;
pitcher : c ; beaker : b b a ; SEPARATE destroy beaker	pitcher : c ;
glass : c g c m g ; mug : m r r f f m ; SEPARATE destroy mug	glass : c g c m g ;
thermos : g g ; glass : b g p b g ; SEPARATE destroy glass	thermos : g g ;
canister : e d m m d e ; beaker : v h v y ; SEPARATE destroy canister	beaker : v h v y ;
glass : a p a p ; thermos : f f ; SEPARATE destroy thermos	glass : a p a p ;
flagon : h h ; burette : d b ; flask : b e e ; SEPARATE destroy flagon	burette : d b ; flask : b e e ;
vessel : h r ; beaker : a b ; SEPARATE destroy beaker	vessel : h r ;
decanter : v v ; flask : b b ; decanter : g g ; SEPARATE destroy second decanter	decanter : v v ; flask : b b ;
jar : v f d d f ; pitcher : e ; flask : e e b b o ; SEPARATE destroy jar	pitcher : e ; flask : e e b b o ;
pitcher : o r o r ; cup : d h g h d ; SEPARATE destroy cup	pitcher : o r o r ;
bottle : r g g h h r ; thermos : b ; SEPARATE destroy thermos	bottle : r g g h h r ;
canister : e b b p p ; canister : d ; flagon : h ; cup : v d ; SEPARATE destroy cup	canister : e b b p p ; canister : d ; flagon : h ;
bottle : m ; vessel : r f g r f ; SEPARATE destroy bottle	vessel : r f g r f ;
cup : y ; pitcher : p v p ; SEPARATE destroy cup	pitcher : p v p ;
cup : b ; vessel : m m ; jar : y ; pitcher : h m m h b ; SEPARATE destroy pitcher	cup : b ; vessel : m m ; jar : y ;
flask : f f m ; pitcher : m ; jar : h a ; jar : r r ; SEPARATE destroy pitcher	flask : f f m ; jar : h a ; jar : r r ;
glass : v r r ; flask : g g ; mug : c ; SEPARATE destroy mug	glass : v r r ; flask : g g ;
thermos : f f ; bottle : y b m ; flask : h e h ; vessel : v v ; SEPARATE destroy flask	thermos : f f ; bottle : y b m ; vessel : v v ;
mug : a a ; decanter : y f f c c y ; pitcher : d d p o ; SEPARATE destroy decanter	mug : a a ; pitcher : d d p o ;
mug : y y ; cup : v ; SEPARATE destroy mug	cup : v ;
bottle : y h m y m ; flask : e o o ; SEPARATE destroy flask	bottle : y h m y m ;
flask : f h g g ; cup : d ; mug : g g h ; SEPARATE destroy flask	cup : d ; mug : g g h ;
jar : r ; decanter : b y e b e ; SEPARATE destroy jar	decanter : b y e b e ;
decanter : g c g ; urn : y y f ; SEPARATE destroy urn	decanter : g c g ;
vessel : m m f p ; urn : h o e e ; decanter : m ; SEPARATE destroy vessel	urn : h o e e ; decanter : m ;
vessel : h d d ; jug : o ; SEPARATE destroy jug	vessel : h d d ;
vessel : y y ; flagon : o o ; SEPARATE destroy flagon	vessel : y y ;
vessel : y r y ; burette : m ; SEPARATE destroy burette	vessel : y r y ;
beaker : f h h e ; decanter : e e ; SEPARATE destroy decanter	beaker : f h h e ;
mug : a m e e m ; thermos : g g ; pitcher : g a y g ; SEPARATE destroy thermos	mug : a m e e m ; pitcher : g a y g ;
thermos : a f f a m ; vessel : c c ; SEPARATE destroy thermos	vessel : c c ;
canister : g ; flask : p c o c ; cup : h r o r h ; SEPARATE destroy canister	flask : p c o c ; cup : h r o r h ;
vessel : b m m ; decanter : a ; SEPARATE destroy decanter	vessel : b m m ;
flagon : g f b b ; decanter : g g o o m ; thermos : d m r ; SEPARATE destroy decanter	flagon : g f b b ; thermos : d m r ;
canister : p p ; vessel : o o p ; SEPARATE destroy vessel	canister : p p ;
decanter : y r y r ; flask : f g f ; decanter : b b ; SEPARATE destroy flask	decanter : y r y r ; decanter : b b ;
mug : p ; burette : a a y ; SEPARATE destroy burette	mug : p ;
urn : f r h ; glass : b v v ; jug : d c m m ; SEPARATE destroy jug	urn : f r h ; glass : b v v ;
glass : o c ; flask : y y ; burette : e ; SEPARATE destroy glass	flask : y y ; burette : e ;
pitcher : h p h c ; decanter : m d a a ; SEPARATE destroy decanter	pitcher : h p h c ;
burette : e ; beaker : p g g ; cup : e e ; SEPARATE destroy burette	beaker : p g g ; cup : e e ;
decanter : d c ; cup : h d d ; SEPARATE destroy decanter	cup : h d d ;
jug : v v ; burette : e p d d p ; SEPARATE destroy jug	burette : e p d d p ;
vessel : e e ; thermos : c c y y ; SEPARATE destroy vessel	thermos : c c y y ;
bottle : g c f f g c ; bottle : e e d d ; glass : h ; SEPARATE destroy first bottle	bottle : e e d d ; glass : h ;
canister : y ; cup : b b ; cup : o o m ; canister : d d ; SEPARATE destroy first cup	canister : y ; cup : o o m ; canister : d d ;
canister : p p ; flask : c p p ; SEPARATE destroy flask	canister : p p ;
vessel : g e g ; jar : r p b r p b ; SEPARATE destroy vessel	jar : r p b r p b ;
cup : c b c ; jar : b b ; SEPARATE destroy jar	cup : c b c ;
glass : f ; flask : f m f m ; SEPARATE destroy glass	flask : f m f m ;
glass : h h ; canister : f ; SEPARATE destroy glass	canister : f ;
flagon : m a v m v ; vessel : h o o ; mug : d d y ; SEPARATE destroy mug	flagon : m a v m v ; vessel : h o o ;
jar : p v g v g ; canister : f f o r r ; SEPARATE destroy jar	canister : f f o r r ;
thermos : f b f ; decanter : g p p ; SEPARATE destroy decanter	thermos : f b f ;
bottle : b p b ; pitcher : c c ; SEPARATE destroy bottle	pitcher : c c ;
glass : h c e e ; flask : g o o ; SEPARATE destroy glass	flask : g o o ;
canister : f o ; bottle : f f ; flask : r h f f ; SEPARATE destroy flask	canister : f o ; bottle : f f ;
bottle : p v p ; pitcher : o o ; SEPARATE destroy pitcher	bottle : p v p ;
urn : r m r ; jug : o ; bottle : e ; cup : y y v ; SEPARATE destroy jug	urn : r m r ; bottle : e ; cup : y y v ;
jar : y r g ; bottle : v h v b b ; SEPARATE destroy bottle	jar : y r g ;
jug : m ; cup : y e r e ; bottle : v ; SEPARATE destroy bottle	jug : m ; cup : y e r e ;
pitcher : e y e ; glass : v ; urn : c c e e h h ; SEPARATE destroy pitcher	glass : v ; urn : c c e e h h ;
beaker : d a d ; pitcher : r r p ; jug : p ; decanter : c c ; SEPARATE destroy jug	beaker : d a d ; pitcher : r r p ; decanter : c c ;
urn : p c c r p ; glass : e d ; cup : h ; SEPARATE destroy glass	urn : p c c r p ; cup : h ;
glass : g g ; decanter : d y y ; burette : v v g ; canister : f ; SEPARATE destroy glass	decanter : d y y ; burette : v v g ; canister : f ;
flask : f c m f ; thermos : a c c y a ; SEPARATE destroy flask	thermos : a c c y a ;
beaker : v v ; flask : g y d d g y ; SEPARATE destroy beaker	flask : g y d d g y ;
mug : p g ; flagon : h h ; bottle : g v ; mug : y y ; SEPARATE destroy flagon	mug : p g ; bottle : g v ; mug : y y ;
thermos : r ; bottle : r v d ; burette : f f ; cup : r ; SEPARATE destroy bottle	thermos : r ; burette : f f ; cup : r ;
flagon : e ; burette : d g g d ; SEPARATE destroy flagon	burette : d g g d ;
mug : m r ; jug : m m ; SEPARATE destroy jug	mug : m r ;
flagon : f o o b ; bottle : d b ; SEPARATE destroy bottle	flagon : f o o b ;
burette : y g ; thermos : r r e e ; SEPARATE destroy thermos	burette : y g ;
glass : d m v m d ; flask : p p ; SEPARATE destroy flask	glass : d m v m d ;
pitcher : a e b ; flask : v v ; thermos : g g ; SEPARATE destroy pitcher	flask : v v ; thermos : g g ;
beaker : o c o ; vessel : r h o o h ; SEPARATE destroy beaker	vessel : r h o o h ;
pitcher : c v ; bottle : e e g o ; SEPARATE destroy bottle	pitcher : c v ;
vessel : a a ; pitcher : c c ; glass : y v v y c ; SEPARATE destroy pitcher	vessel : a a ; glass : y v v y c ;
burette : c g c ; thermos : p p ; jar : b b ; SEPARATE destroy thermos	burette : c g c ; jar : b b ;
jar : d d ; decanter : c y y ; SEPARATE destroy decanter	jar : d d ;
flagon : y y ; flask : e e ; canister : h h ; SEPARATE destroy canister	flagon : y y ; flask : e e ;
decanter : v v g ; thermos : d r r d ; SEPARATE destroy decanter	thermos : d r r d ;
jar : p p g ; jug : r v v r ; urn : v ; SEPARATE destroy jar	jug : r v v r ; urn : v ;
glass : v g v a ; jug : r r ; bottle : c m c m ; SEPARATE destroy glass	jug : r r ; bottle : c m c m ;
mug : g b g c c ; burette : r r f ; SEPARATE destroy burette	mug : g b g c c ;
burette : r r ; bottle : v v ; pitcher : y c c y ; jug : v ; SEPARATE destroy jug	burette : r r ; bottle : v v ; pitcher : y c c y ;
decanter : o v b b ; decanter : b b ; mug : f a v a ; SEPARATE destroy last decanter	decanter : o v b b ; mug : f a v a ;
urn : p h h e ; pitcher : c ; thermos : d p h p h ; SEPARATE destroy urn	pitcher : c ; thermos : d p h p h ;
flask : f h f ; pitcher : f f c c ; jar : d h ; SEPARATE destroy pitcher	flask : f h f ; jar : d h ;
flagon : p b b ; beaker : m b b p p ; burette : v v ; SEPARATE destroy flagon	beaker : m b b p p ; burette : v v ;
jar : g ; bottle : o ; pitcher : v h h v g ; SEPARATE destroy pitcher	jar : g ; bottle : o ;
thermos : y r y r o ; jar : r ; urn : m e e p ; SEPARATE destroy urn	thermos : y r y r o ; jar : r ;
mug : m m ; canister : a a o ; jar : e e o ; SEPARATE destroy jar	mug : m m ; canister : a a o ;
cup : e m m ; bottle : m m ; SEPARATE destroy cup	bottle : m m ;
jar : e c c b e ; bottle : m m v ; SEPARATE destroy bottle	jar : e c c b e ;
mug : r r o m o ; pitcher : d m r d ; SEPARATE destroy mug	pitcher : d m r d ;
canister : g y f ; jug : o e e v ; flask : b f b p p ; SEPARATE destroy canister	jug : o e e v ; flask : b f b p p ;
flask : a a ; jar : d a a d ; SEPARATE destroy flask	jar : d a a d ;
jug : c e d c e ; bottle : h h p d ; thermos : p p h ; SEPARATE destroy bottle	jug : c e d c e ; thermos : p p h ;
thermos : o f g ; bottle : h p p ; beaker : o o g ; SEPARATE destroy thermos	bottle : h p p ; beaker : o o g ;
bottle : p p m ; thermos : e ; SEPARATE destroy bottle	thermos : e ;
cup : f ; flagon : d ; jug : e y f e y f ; SEPARATE destroy jug	cup : f ; flagon : d ;
flask : e v v ; mug : d ; thermos : b g r g b r ; SEPARATE destroy mug	flask : e v v ; thermos : b g r g b r ;
bottle : a ; cup : c ; urn : f f ; SEPARATE destroy cup	bottle : a ; urn : f f ;
decanter : f h ; burette : v b v m ; thermos : a ; cup : r r ; SEPARATE destroy decanter	burette : v b v m ; thermos : a ; cup : r r ;
thermos : f m m h h ; flask : v b c v ; canister : d d ; SEPARATE destroy canister	thermos : f m m h h ; flask : v b c v ;
beaker : r g ; flagon : o ; canister : a m m g ; SEPARATE destroy canister	beaker : r g ; flagon : o ;
bottle : f v f v r ; thermos : b ; burette : b b ; SEPARATE destroy bottle	thermos : b ; burette : b b ;
burette : e v e ; flask : f h ; jug : f p ; SEPARATE destroy jug	burette : e v e ; flask : f h ;
jug : d d ; bottle : p p o o b ; SEPARATE destroy bottle	jug : d d ;
beaker : p p m m ; mug : m ; SEPARATE destroy beaker	mug : m ;
beaker : d d ; burette : d d ; urn : e e ; SEPARATE destroy urn	beaker : d d ; burette : d d ;
canister : v ; decanter : h h g o ; jar : r m ; SEPARATE destroy jar	canister : v ; decanter : h h g o ;
thermos : a a ; glass : d ; glass : f f ; SEPARATE destroy first glass	thermos : a a ; glass : f f ;
jar : g g ; urn : a o b ; thermos : v b b o ; SEPARATE destroy jar	urn : a o b ; thermos : v b b o ;
beaker : v a a ; bottle : c f f o ; flask : p p ; SEPARATE destroy flask	beaker : v a a ; bottle : c f f o ;
flagon : c c d a ; urn : c c m h ; SEPARATE destroy flagon	urn : c c m h ;
flagon : c ; decanter : g ; SEPARATE destroy flagon	decanter : g ;
bottle : h p p ; thermos : a b ; pitcher : y y ; SEPARATE destroy thermos	bottle : h p p ; pitcher : y y ;
vessel : o e o ; burette : m m p h ; bottle : r a r ; SEPARATE destroy bottle	vessel : o e o ; burette : m m p h ;
beaker : c p p m c ; flask : y g ; SEPARATE destroy flask	beaker : c p p m c ;
bottle : a d a ; cup : b h h o o b ; SEPARATE destroy cup	bottle : a d a ;
urn : f ; flagon : g y g ; bottle : c p a c ; SEPARATE destroy bottle	urn : f ; flagon : g y g ;
urn : c o h c ; decanter : v v ; SEPARATE destroy urn	decanter : v v ;
jug : f ; jar : m ; SEPARATE destroy jar	jug : f ;
bottle : f ; burette : h ; glass : f e r f e ; SEPARATE destroy glass	bottle : f ; burette : h ;
glass : e b b ; urn : m m f ; SEPARATE destroy glass	urn : m m f ;
urn : y g g ; thermos : e p a p ; decanter : h h e ; SEPARATE destroy thermos	urn : y g g ; decanter : h h e ;
beaker : h h ; canister : o m o ; glass : h ; SEPARATE destroy canister	beaker : h h ; glass : h ;
thermos : g p a p ; decanter : f r f ; mug : r v v r ; SEPARATE destroy decanter	thermos : g p a p ; mug : r v v r ;
canister : y f ; flagon : b ; SEPARATE destroy flagon	canister : y f ;
flask : y y ; beaker : p p a a ; SEPARATE destroy flask	beaker : p p a a ;
urn : h v p h ; canister : p p ; decanter : c p ; SEPARATE destroy decanter	urn : h v p h ; canister : p p ;
decanter : c c ; canister : v v ; jug : b ; SEPARATE destroy decanter	canister : v v ; jug : b ;
jug : p ; mug : h h ; mug : d d ; SEPARATE destroy last mug	jug : p ; mug : h h ;
flask : v h h ; bottle : v f v f ; thermos : y m y m ; SEPARATE destroy thermos	flask : v h h ; bottle : v f v f ;
beaker : y ; decanter : e e g b g ; SEPARATE destroy beaker	decanter : e e g b g ;
flagon : e ; canister : h ; bottle : d ; SEPARATE destroy flagon	canister : h ; bottle : d ;
jar : y y m o ; flask : f e e f ; SEPARATE destroy jar	flask : f e e f ;
glass : b b ; jug : a f p ; burette : b b ; mug : a a ; SEPARATE destroy jug	glass : b b ; burette : b b ; mug : a a ;
burette : g b ; jar : f f ; SEPARATE destroy burette	jar : f f ;
burette : g v g p ; flask : h a a h ; SEPARATE destroy flask	burette : g v g p ;
jug : v b v ; urn : v v ; mug : v v b ; SEPARATE destroy mug	jug : v b v ; urn : v v ;
burette : e o e h h ; beaker : h y y p ; SEPARATE destroy beaker	burette : e o e h h ;
beaker : m v m f ; flagon : b g b ; flagon : y y ; SEPARATE destroy beaker	flagon : b g b ; flagon : y y ;
beaker : c p c p ; bottle : f ; thermos : b b ; SEPARATE destroy bottle	beaker : c p c p ; thermos : b b ;
canister : h m ; urn : g e e ; vessel : e e d d ; SEPARATE destroy canister	urn : g e e ; vessel : e e d d ;
jar : r y v r y ; decanter : c v a c v ; SEPARATE destroy jar	decanter : c v a c v ;
jar : b b ; burette : m ; jug : f v ; thermos : b b p ; SEPARATE destroy burette	jar : b b ; jug : f v ; thermos : b b p ;
flagon : v v ; thermos : r p e e ; SEPARATE destroy flagon	thermos : r p e e ;
bottle : r h ; mug : v m m v ; cup : g a ; SEPARATE destroy mug	bottle : r h ; cup : g a ;
pitcher : v v p g ; glass : e o e y o ; urn : c y ; SEPARATE destroy glass	pitcher : v v p g ; urn : c y ;
bottle : v g p v ; jug : p v m ; SEPARATE destroy bottle	jug : p v m ;
beaker : r a a ; vessel : o ; jug : d ; SEPARATE destroy vessel	beaker : r a a ; jug : d ;
beaker : r r m b b m ; glass : f r f v ; SEPARATE destroy glass	beaker : r r m b b m ;
beaker : b a a ; urn : v g f v f ; SEPARATE destroy urn	beaker : b a a ;
vessel : d d g e e ; pitcher : r c ; SEPARATE destroy vessel	pitcher : r c ;
decanter : v m v ; bottle : f o f o ; decanter : b ; SEPARATE destroy bottle	decanter : v m v ; decanter : b ;
beaker : o ; flagon : r d b ; vessel : f e f m e ; SEPARATE destroy beaker	flagon : r d b ; vessel : f e f m e ;
burette : m m e c ; pitcher : p y y ; cup : o p o p ; SEPARATE destroy pitcher	burette : m m e c ; cup : o p o p ;
flask : m d ; decanter : a f g ; SEPARATE destroy decanter	flask : m d ;
cup : h a a ; pitcher : h a h p ; bottle : g g ; SEPARATE destroy bottle	cup : h a a ; pitcher : h a h p ;
beaker : r r ; jug : d d y ; vessel : y y ; SEPARATE destroy beaker	jug : d d y ; vessel : y y ;
pitcher : c d d c ; burette : p y v v y p ; flask : p r ; SEPARATE destroy burette	pitcher : c d d c ; flask : p r ;
vessel : h h m ; flagon : h ; glass : b b f ; jug : g ; SEPARATE destroy flagon	vessel : h h m ; glass : b b f ; jug : g ;
urn : g v g p ; bottle : c m r c ; urn : f p ; SEPARATE destroy first urn	bottle : c m r c ; urn : f p ;
decanter : p b v b p ; beaker : m g m e e ; SEPARATE destroy beaker	decanter : p b v b p ;
cup : c c h g h ; burette : f ; beaker : a ; SEPARATE destroy burette	cup : c c h g h ; beaker : a ;
bottle : f r r ; glass : h e h c e ; SEPARATE destroy glass	bottle : f r r ;
flagon : a a c c ; decanter : v v ; SEPARATE destroy flagon	decanter : v v ;
